group,fips_code,clinton_votes,sanders_votes,clinton_margin,clinton_percent
Alabama,01001,2387,544,1843,0.6287956328897987
Alabama,01003,5290,2694,2596,0.3251503006012024
Alabama,01005,2567,222,2345,0.8408031552527788
Alabama,01007,942,246,696,0.5858585858585859
Alabama,01009,564,395,169,0.1762252346193952
Alabama,01011,2451,178,2273,0.8645872955496386
Alabama,01013,2196,156,2040,0.8673469387755102
Alabama,01015,5011,1425,3586,0.5571783716594157
Alabama,01017,2899,312,2587,0.805668016194332
Alabama,01019,712,268,444,0.4530612244897959
Alabama,01021,860,289,571,0.4969538729329852
Alabama,01023,1772,273,1499,0.7330073349633252
Alabama,01025,3148,213,2935,0.8732520083308539
Alabama,01027,807,135,672,0.7133757961783439
Alabama,01029,221,72,149,0.5085324232081911
Alabama,01031,1493,389,1104,0.5866099893730075
Alabama,01033,3879,1342,2537,0.4859222371193258
Alabama,01035,2031,544,1487,0.5774757281553398
Alabama,01037,1012,125,887,0.7801231310466139
Alabama,01039,737,188,549,0.5935135135135136
Alabama,01041,908,107,801,0.7891625615763547
Alabama,01043,1275,723,552,0.27627627627627627
Alabama,01045,1544,415,1129,0.5763144461459928
Alabama,01047,8577,1774,6803,0.6572311853927156
Alabama,01049,1297,667,630,0.32077393075356414
Alabama,01051,3019,694,2325,0.6261782924858605
Alabama,01053,2027,226,1801,0.7993786063027075
Alabama,01055,4262,1289,2973,0.5355791749234372
Alabama,01057,660,148,512,0.6336633663366337
Alabama,01059,1233,767,466,0.233
Alabama,01061,544,157,387,0.5520684736091298
Alabama,01063,2714,213,2501,0.8544584899214213
Alabama,01065,2426,427,1999,0.7006659656501928
Alabama,01067,1170,163,1007,0.7554388597149287
Alabama,01069,3044,780,2264,0.5920502092050209
Alabama,01071,1327,510,817,0.4447468698965705
Alabama,01073,67357,14319,53038,0.6493706841667075
Alabama,01075,442,173,269,0.4373983739837398
Alabama,01077,3676,1745,1931,0.3562073418188526
Alabama,01079,2047,428,1619,0.6541414141414141
Alabama,01081,7137,2464,4673,0.4867201333194459
Alabama,01083,3199,1120,2079,0.4813614262560778
Alabama,01085,3782,330,3452,0.8394941634241245
Alabama,01087,4293,483,3810,0.7977386934673367
Alabama,01089,19995,8786,11209,0.3894583231993329
Alabama,01091,3590,1092,2498,0.5335326783425887
Alabama,01093,567,256,311,0.3778857837181045
Alabama,01095,1494,821,673,0.29071274298056154
Alabama,01097,28927,5672,23255,0.6721292522905287
Alabama,01099,2438,205,2233,0.8448732500945895
Alabama,01101,28650,4266,24384,0.7407947502734232
Alabama,01103,3897,1345,2552,0.4868370850820298
Alabama,01105,2575,389,2186,0.7375168690958165
Alabama,01107,2326,453,1873,0.6739834472831954
Alabama,01109,2183,379,1804,0.7041373926619828
Alabama,01111,1236,328,908,0.5805626598465473
Alabama,01113,4381,988,3393,0.6319612590799032
Alabama,01115,1808,745,1063,0.4163728946337642
Alabama,01117,6657,3755,2902,0.2787168651555897
Alabama,01119,2987,416,2571,0.7555098442550691
Alabama,01121,5561,782,4779,0.7534289768248463
Alabama,01123,2658,308,2350,0.7923128792987189
Alabama,01125,12136,3444,8692,0.5578947368421052
Alabama,01127,1772,727,1045,0.4181672669067627
Alabama,01129,1511,562,949,0.45779064158224797
Alabama,01131,3337,410,2927,0.7811582599412864
Alabama,01133,303,138,165,0.3741496598639456
Alaska,02000,99,440,-341,-0.632653061
Arizona,04001,4450,1933,2517,0.3943286855710481
Arizona,04003,4654,3265,1389,0.1754009344614219
Arizona,04005,5738,6941,-1203,-0.09488129978704946
Arizona,04007,2196,1305,891,0.2544987146529563
Arizona,04009,937,851,86,0.04809843400447427
Arizona,04011,497,325,172,0.20924574209245742
Arizona,04012,309,259,50,0.0880281690140845
Arizona,04013,126988,86942,40046,0.18719207217314074
Arizona,04015,4170,2847,1323,0.18854211201368107
Arizona,04017,4415,2621,1794,0.2549744172825469
Arizona,04019,56317,40228,16089,0.16664767724895127
Arizona,04021,9771,5414,4357,0.2869278893645044
Arizona,04023,2496,1205,1291,0.3488246419886517
Arizona,04025,8401,7108,1293,0.08337094590237927
Arizona,04027,4358,2156,2202,0.3380411421553577
Arkansas,05001,724,132,592,0.6915887850467289
Arkansas,05003,1375,980,395,0.16772823779193205
Arkansas,05005,1391,807,584,0.2656960873521383
Arkansas,05007,5650,4696,954,0.09220954958438043
Arkansas,05009,721,469,252,0.21176470588235294
Arkansas,05011,593,106,487,0.6967095851216023
Arkansas,05013,413,312,101,0.1393103448275862
Arkansas,05015,0,0,0,0
Arkansas,05017,1370,247,1123,0.6944959802102659
Arkansas,05019,1650,494,1156,0.539179104477612
Arkansas,05021,960,656,304,0.18811881188118812
Arkansas,05023,758,316,442,0.41154562383612664
Arkansas,05025,382,137,245,0.4720616570327553
Arkansas,05027,1008,306,702,0.5342465753424658
Arkansas,05029,1755,840,915,0.35260115606936415
Arkansas,05031,3543,1862,1681,0.3110083256244218
Arkansas,05033,1586,874,712,0.2894308943089431
Arkansas,05035,3379,722,2657,0.6478907583516216
Arkansas,05037,780,228,552,0.5476190476190477
Arkansas,05039,693,361,332,0.31499051233396586
Arkansas,05041,1342,449,893,0.49860413176996093
Arkansas,05043,1250,475,775,0.4492753623188406
Arkansas,05045,4077,2774,1303,0.19019121296161146
Arkansas,05047,667,294,373,0.3881373569198751
Arkansas,05049,701,473,228,0.19420783645655879
Arkansas,05051,4057,1779,2278,0.39033584647018504
Arkansas,05053,690,300,390,0.3939393939393939
Arkansas,05055,1236,585,651,0.357495881383855
Arkansas,05057,786,164,622,0.6547368421052632
Arkansas,05059,1562,730,832,0.36300174520069806
Arkansas,05061,535,129,406,0.6114457831325302
Arkansas,05063,1059,521,538,0.34050632911392403
Arkansas,05065,516,239,277,0.36688741721854307
Arkansas,05067,702,225,477,0.5145631067961165
Arkansas,05069,9936,2115,7821,0.648991784914115
Arkansas,05071,1056,580,476,0.29095354523227385
Arkansas,05073,443,160,283,0.4693200663349917
Arkansas,05075,933,726,207,0.12477396021699819
Arkansas,05077,956,84,872,0.8384615384615385
Arkansas,05079,599,152,447,0.5952063914780293
Arkansas,05081,721,441,280,0.24096385542168675
Arkansas,05083,881,361,520,0.41867954911433175
Arkansas,05085,1664,817,847,0.34139459895203544
Arkansas,05087,1085,1078,7,0.003236245954692557
Arkansas,05089,421,314,107,0.145578231292517
Arkansas,05091,1300,356,944,0.5700483091787439
Arkansas,05093,2017,342,1675,0.7100466299279355
Arkansas,05095,843,411,432,0.3444976076555024
Arkansas,05097,316,142,174,0.3799126637554585
Arkansas,05099,647,306,341,0.3578174186778594
Arkansas,05101,192,211,-19,-0.04714640198511166
Arkansas,05103,2095,525,1570,0.5992366412213741
Arkansas,05105,648,428,220,0.20446096654275092
Arkansas,05107,2696,656,2040,0.6085918854415274
Arkansas,05109,367,171,196,0.3643122676579926
Arkansas,05111,717,228,489,0.5174603174603175
Arkansas,05113,349,272,77,0.12399355877616747
Arkansas,05115,1680,1169,511,0.17936117936117937
Arkansas,05117,558,385,173,0.18345705196182396
Arkansas,05119,34862,10461,24401,0.5383800719281601
Arkansas,05121,662,356,306,0.3005893909626719
Arkansas,05123,1912,354,1558,0.6875551632833187
Arkansas,05125,4358,2008,2350,0.36914860194784793
Arkansas,05127,306,151,155,0.33916849015317285
Arkansas,05129,221,164,57,0.14805194805194805
Arkansas,05131,3694,2226,1468,0.24797297297297297
Arkansas,05133,342,167,175,0.343811394891945
Arkansas,05135,608,294,314,0.34811529933481156
Arkansas,05137,547,421,126,0.13016528925619836
Arkansas,05139,2548,1669,879,0.20844202039364476
Arkansas,05141,770,436,334,0.2769485903814262
Arkansas,05143,9110,8507,603,0.034228302208094454
Arkansas,05145,2024,818,1206,0.4243490499648135
Arkansas,05147,862,292,570,0.49393414211438474
Arkansas,05149,723,432,291,0.2519480519480519
California,06001,107102,91324,15778,0.0795157892614879
California,06003,110,129,-19,-0.0794979079497908
California,06005,1949,1753,196,0.05294435440302539
California,06007,9681,14271,-4590,-0.19163326653306614
California,06009,2630,2392,238,0.04739147749900438
California,06011,653,584,69,0.05578011317704123
California,06013,69809,46909,22900,0.1961993865556298
California,06015,1015,1323,-308,-0.1317365269461078
California,06017,10367,9497,870,0.043797825211437776
California,06019,32895,21672,11223,0.20567375886524822
California,06021,649,644,5,0.0038669760247486465
California,06023,6036,13245,-7209,-0.3738913956744982
California,06025,5743,2731,3012,0.35544016993155536
California,06027,756,957,-201,-0.11733800350262696
California,06029,19104,13475,5629,0.17278001166395532
California,06031,3921,2548,1373,0.21224300510125213
California,06033,2408,2704,-296,-0.057902973395931145
California,06035,690,770,-80,-0.0547945205479452
California,06037,590502,434656,155846,0.15202144449928695
California,06039,4831,3626,1205,0.14248551495802295
California,06041,27238,19848,7390,0.1569468631865098
California,06043,963,1050,-87,-0.043219076005961254
California,06045,2690,4654,-1964,-0.26742919389978215
California,06047,7169,5190,1979,0.16012622380451494
California,06049,240,280,-40,-0.07692307692307693
California,06051,755,917,-162,-0.09688995215311005
California,06053,17126,12894,4232,0.14097268487674883
California,06055,7370,4781,2589,0.2130688832194881
California,06057,5591,8472,-2881,-0.2048638270639266
California,06059,123723,100836,22887,0.10191976273496052
California,06061,17299,12787,4512,0.14997008575417137
California,06063,1209,1476,-267,-0.09944134078212291
California,06065,73724,47988,25736,0.21144998028131984
California,06067,68248,50567,17681,0.14881117703993604
California,06069,2022,1439,583,0.16844842531060386
California,06071,71246,51770,19476,0.15832086883007088
California,06073,139813,111898,27915,0.11090099359980295
California,06075,85070,67191,17879,0.11742337171041829
California,06077,25118,16329,8789,0.2120539484160494
California,06079,16833,16147,686,0.02080048514251061
California,06081,47358,30003,17355,0.22433784465040524
California,06083,23543,22976,567,0.012188568111954255
California,06085,109963,70468,39495,0.21889254063880376
California,06087,20105,25171,-5066,-0.11189150985069353
California,06089,5875,6140,-265,-0.022055763628797336
California,06091,213,275,-62,-0.12704918032786885
California,06093,1585,2301,-716,-0.184251158003088
California,06095,31753,23630,8123,0.14666955563981726
California,06097,44923,42715,2208,0.025194550309226592
California,06099,15309,12086,3223,0.11764920605949991
California,06101,2370,1894,476,0.11163227016885553
California,06103,1487,1544,-57,-0.018805674694820192
California,06105,585,953,-368,-0.23927178153446033
California,06107,8375,5755,2620,0.1854210898796886
California,06109,2851,2623,228,0.04165144318597004
California,06111,45848,38523,7325,0.08681893067523201
California,06113,12567,11532,1035,0.042947840159342714
California,06115,1572,1730,-158,-0.04784978800726832
Colorado,08001,2060,3279,-1219,-0.2283199100955235
Colorado,08003,90,167,-77,-0.29961089494163423
Colorado,08005,5320,6086,-766,-0.06715763633175521
Colorado,08007,83,156,-73,-0.3054393305439331
Colorado,08009,15,14,1,0.034482758620689655
Colorado,08011,26,24,2,0.04
Colorado,08013,6354,11142,-4788,-0.2736625514403292
Colorado,08014,563,1010,-447,-0.28417037507946596
Colorado,08015,210,404,-194,-0.31596091205211724
Colorado,08017,5,4,1,0.1111111111111111
Colorado,08019,159,199,-40,-0.11173184357541899
Colorado,08021,73,50,23,0.18699186991869918
Colorado,08023,64,23,41,0.47126436781609193
Colorado,08025,15,16,-1,-0.03225806451612903
Colorado,08027,34,45,-11,-0.13924050632911392
Colorado,08029,177,417,-240,-0.40404040404040403
Colorado,08031,12097,14624,-2527,-0.09456981400396691
Colorado,08033,8,22,-14,-0.4666666666666667
Colorado,08035,2342,2347,-5,-0.0010663254425250586
Colorado,08037,344,623,-279,-0.28852119958634953
Colorado,08039,89,144,-55,-0.23605150214592274
Colorado,08041,3109,4954,-1845,-0.22882301872752078
Colorado,08043,193,268,-75,-0.16268980477223427
Colorado,08045,439,734,-295,-0.2514919011082694
Colorado,08047,74,173,-99,-0.4008097165991903
Colorado,08049,94,187,-93,-0.3309608540925267
Colorado,08051,141,481,-340,-0.5466237942122186
Colorado,08053,3,10,-7,-0.5384615384615384
Colorado,08055,93,150,-57,-0.2345679012345679
Colorado,08057,15,12,3,0.1111111111111111
Colorado,08059,5478,8281,-2803,-0.20372120066865324
Colorado,08061,5,2,3,0.42857142857142855
Colorado,08063,11,16,-5,-0.18518518518518517
Colorado,08065,53,165,-112,-0.5137614678899083
Colorado,08067,819,1466,-647,-0.2831509846827133
Colorado,08069,3281,6744,-3463,-0.3454364089775561
Colorado,08071,80,106,-26,-0.13978494623655913
Colorado,08073,20,14,6,0.17647058823529413
Colorado,08075,77,70,7,0.047619047619047616
Colorado,08077,791,1095,-304,-0.16118769883351008
Colorado,08079,16,25,-9,-0.21951219512195122
Colorado,08081,21,28,-7,-0.14285714285714285
Colorado,08083,198,412,-214,-0.35081967213114756
Colorado,08085,210,258,-48,-0.10256410256410256
Colorado,08087,70,87,-17,-0.10828025477707007
Colorado,08089,78,94,-16,-0.09302325581395349
Colorado,08091,86,156,-70,-0.2892561983471074
Colorado,08093,118,231,-113,-0.3237822349570201
Colorado,08095,11,18,-7,-0.2413793103448276
Colorado,08097,349,421,-72,-0.09350649350649351
Colorado,08099,40,18,22,0.3793103448275862
Colorado,08101,1260,1140,120,0.05
Colorado,08103,8,18,-10,-0.38461538461538464
Colorado,08105,47,59,-12,-0.11320754716981132
Colorado,08107,230,406,-176,-0.27672955974842767
Colorado,08109,47,219,-172,-0.6466165413533834
Colorado,08111,11,27,-16,-0.42105263157894735
Colorado,08113,89,329,-240,-0.5741626794258373
Colorado,08115,13,8,5,0.23809523809523808
Colorado,08117,276,419,-143,-0.20575539568345325
Colorado,08119,126,219,-93,-0.26956521739130435
Colorado,08121,10,12,-2,-0.09090909090909091
Colorado,08123,1051,1754,-703,-0.25062388591800355
Colorado,08125,45,33,12,0.15384615384615385
Connecticut,09001,46649,29595,17054,0.22367661717643356
Connecticut,09003,48096,40445,7651,0.08641194474876046
Connecticut,09005,6653,9029,-2376,-0.15151128682565998
Connecticut,09007,8517,9838,-1321,-0.0719694906020158
Connecticut,09009,40628,36275,4353,0.05660377358490566
Connecticut,09011,10516,13135,-2619,-0.11073527546403958
Connecticut,09013,5620,8734,-3114,-0.21694301240072453
Connecticut,09015,3396,5359,-1963,-0.2242147344374643
Delaware,10001,7338,4980,2358,0.1914271797369703
Delaware,10003,38580,25738,12842,0.19966416866196088
Delaware,10005,10032,5941,4091,0.25611970199712014
Florida,12001,17733,17590,143,0.004048353763836594
Florida,12003,654,805,-151,-0.10349554489376285
Florida,12005,5209,4131,1078,0.11541755888650963
Florida,12007,1056,908,148,0.07535641547861507
Florida,12009,31835,20083,11752,0.22635694749412535
Florida,12011,132527,48330,84197,0.4655446015360202
Florida,12013,437,545,-108,-0.109979633401222
Florida,12015,8125,4634,3491,0.27361078454424326
Florida,12017,6863,4776,2087,0.17931093736575307
Florida,12019,5345,3698,1647,0.1821298241733938
Florida,12021,12712,6127,6585,0.3495408461170975
Florida,12023,2299,1676,623,0.15672955974842767
Florida,12027,987,726,261,0.15236427320490367
Florida,12029,409,459,-50,-0.0576036866359447
Florida,12031,58632,26716,31916,0.3739513521113559
Florida,12033,16765,9318,7447,0.2855116359314496
Florida,12035,6152,2977,3175,0.34779274838426993
Florida,12037,665,647,18,0.013719512195121951
Florida,12039,7446,1944,5502,0.5859424920127796
Florida,12041,428,578,-150,-0.14910536779324055
Florida,12043,387,313,74,0.10571428571428572
Florida,12045,568,520,48,0.04411764705882353
Florida,12047,758,479,279,0.2255456750202102
Florida,12049,529,393,136,0.1475054229934924
Florida,12051,1156,647,509,0.2823072656683306
Florida,12053,8882,5512,3370,0.23412532999861052
Florida,12055,3711,2054,1657,0.28742411101474413
Florida,12057,68936,38505,30431,0.2832345194106533
Florida,12059,339,619,-280,-0.29227557411273486
Florida,12061,6897,3926,2971,0.27450799223875083
Florida,12063,2798,1840,958,0.2065545493747305
Florida,12065,1671,762,909,0.37361282367447596
Florida,12067,295,501,-206,-0.25879396984924624
Florida,12069,15914,8465,7449,0.30554985848476146
Florida,12071,27940,15624,12316,0.2827104949040492
Florida,12073,27333,19866,7467,0.15820250429034513
Florida,12075,1570,1354,216,0.07387140902872777
Florida,12077,316,392,-76,-0.10734463276836158
Florida,12079,1542,741,801,0.3508541392904074
Florida,12081,18116,10165,7951,0.28114281673208164
Florida,12083,18220,9892,8328,0.2962435970404098
Florida,12085,6523,4101,2422,0.22797439759036145
Florida,12086,129467,42009,87458,0.510030558212228
Florida,12087,4830,3739,1091,0.12731940716536352
Florida,12089,2910,2060,850,0.1710261569416499
Florida,12091,4559,3782,777,0.09315429804579786
Florida,12093,1150,784,366,0.1892450879007239
Florida,12095,66654,36639,30015,0.2905811623246493
Florida,12097,16512,7273,9239,0.388438091233971
Florida,12099,103369,39314,64055,0.4489322484108128
Florida,12101,21760,14493,7267,0.20045237635506027
Florida,12103,63699,39742,23957,0.23160062257712125
Florida,12105,29328,15473,13855,0.3092564898104953
Florida,12107,3182,2747,435,0.07336819025130713
Florida,12109,9734,6953,2781,0.1666566788518008
Florida,12111,17554,8091,9463,0.36899980503022034
Florida,12113,3938,3602,336,0.04456233421750663
Florida,12115,25881,15776,10105,0.24257627769642556
Florida,12117,22069,15100,6969,0.1874949554736474
Florida,12119,7022,3022,4000,0.39824771007566706
Florida,12121,1475,1550,-75,-0.024793388429752067
Florida,12123,983,907,76,0.04021164021164021
Florida,12125,336,472,-136,-0.16831683168316833
Florida,12127,26276,16170,10106,0.23809075060076332
Florida,12129,1659,1424,235,0.07622445669802141
Florida,12131,1515,1361,154,0.05354659248956885
Florida,12133,858,781,77,0.04697986577181208
Georgia,13001,490,142,348,0.5506329113924051
Georgia,13003,201,49,152,0.608
Georgia,13005,113,58,55,0.3216374269005848
Georgia,13007,303,48,255,0.7264957264957265
Georgia,13009,3034,762,2272,0.5985247629083246
Georgia,13011,172,169,3,0.008797653958944282
Georgia,13013,1457,879,578,0.24743150684931506
Georgia,13015,2216,1490,726,0.1958985429033999
Georgia,13017,779,179,600,0.6263048016701461
Georgia,13019,325,146,179,0.38004246284501064
Georgia,13021,12944,2632,10312,0.6620441705187468
Georgia,13023,370,98,272,0.5811965811965812
Georgia,13025,137,123,14,0.05384615384615385
Georgia,13027,714,198,516,0.5657894736842105
Georgia,13029,893,501,392,0.2812051649928264
Georgia,13031,1910,1221,689,0.22005748961992974
Georgia,13033,1659,184,1475,0.8003255561584374
Georgia,13035,922,191,731,0.6567834681042228
Georgia,13037,499,61,438,0.7821428571428571
Georgia,13039,1405,688,717,0.3425704730052556
Georgia,13043,434,110,324,0.5955882352941176
Georgia,13045,3173,1933,1240,0.2428515471993733
Georgia,13047,1082,1026,56,0.026565464895635674
Georgia,13049,275,84,191,0.532033426183844
Georgia,13051,19898,7496,12402,0.45272687449806526
Georgia,13053,182,40,142,0.6396396396396397
Georgia,13055,566,302,264,0.30414746543778803
Georgia,13057,4837,4438,399,0.0430188679245283
Georgia,13059,7089,6845,244,0.017511123869671307
Georgia,13061,297,44,253,0.7419354838709677
Georgia,13063,25130,5551,19579,0.6381473876340407
Georgia,13065,167,38,129,0.6292682926829268
Georgia,13067,39277,22390,16887,0.2738417630174972
Georgia,13069,1094,309,785,0.5595153243050606
Georgia,13071,1035,302,733,0.5482423335826477
Georgia,13073,4805,2333,2472,0.3463154945362847
Georgia,13075,580,171,409,0.5446071904127829
Georgia,13077,4536,2233,2303,0.34022750775594623
Georgia,13079,493,120,373,0.6084828711256117
Georgia,13081,729,172,557,0.6182019977802442
Georgia,13083,241,230,11,0.02335456475583864
Georgia,13085,312,268,44,0.07586206896551724
Georgia,13087,1316,333,983,0.5961188599151
Georgia,13089,82348,32572,49776,0.4331360946745562
Georgia,13091,579,141,438,0.6083333333333333
Georgia,13093,737,91,646,0.7801932367149759
Georgia,13095,8891,1435,7456,0.7220608173542514
Georgia,13097,9375,3139,6236,0.49832187949496565
Georgia,13099,671,76,595,0.7965194109772423
Georgia,13101,32,36,-4,-0.058823529411764705
Georgia,13103,1178,620,558,0.3103448275862069
Georgia,13105,805,257,548,0.5160075329566854
Georgia,13107,755,144,611,0.6796440489432704
Georgia,13109,347,85,262,0.6064814814814815
Georgia,13111,545,356,189,0.2097669256381798
Georgia,13113,7257,2918,4339,0.42643734643734643
Georgia,13115,2555,1356,1199,0.3065712094093582
Georgia,13117,3701,3142,559,0.08168931755078182
Georgia,13119,352,203,149,0.26846846846846845
Georgia,13121,82576,33320,49256,0.425001725685097
Georgia,13123,489,421,68,0.07472527472527472
Georgia,13125,38,19,19,0.3333333333333333
Georgia,13127,2870,1277,1593,0.3841331082710393
Georgia,13129,776,553,223,0.16779533483822423
Georgia,13131,887,261,626,0.5452961672473867
Georgia,13133,1076,169,907,0.7285140562248996
Georgia,13135,37465,18883,18582,0.32977213033293107
Georgia,13137,608,553,55,0.047372954349698536
Georgia,13139,3482,2245,1237,0.21599441243233805
Georgia,13141,1112,145,967,0.7692919649960223
Georgia,13143,413,311,102,0.1408839779005525
Georgia,13145,1372,448,924,0.5076923076923077
Georgia,13147,740,276,464,0.4566929133858268
Georgia,13149,276,111,165,0.4263565891472868
Georgia,13151,15639,4406,11233,0.5603891244699426
Georgia,13153,6274,1946,4328,0.5265206812652068
Georgia,13155,326,74,252,0.63
Georgia,13157,1193,729,464,0.24141519250780438
Georgia,13159,632,133,499,0.6522875816993464
Georgia,13161,400,106,294,0.5810276679841897
Georgia,13163,1519,189,1330,0.7786885245901639
Georgia,13165,355,64,291,0.6945107398568019
Georgia,13167,388,64,324,0.7168141592920354
Georgia,13169,1585,371,1214,0.6206543967280164
Georgia,13171,868,208,660,0.6133828996282528
Georgia,13173,234,69,165,0.5445544554455446
Georgia,13175,2294,453,1841,0.6701856570804514
Georgia,13177,1009,335,674,0.5014880952380952
Georgia,13179,2783,678,2105,0.6082057208899162
Georgia,13181,538,93,445,0.705229793977813
Georgia,13183,261,111,150,0.4032258064516129
Georgia,13185,3891,1791,2100,0.36958817317845827
Georgia,13187,560,532,28,0.02564102564102564
Georgia,13189,1274,223,1051,0.7020708082832331
Georgia,13191,863,149,714,0.7055335968379447
Georgia,13193,977,105,872,0.8059149722735675
Georgia,13195,656,505,151,0.13006029285099052
Georgia,13197,431,120,311,0.5644283121597096
Georgia,13199,1463,237,1226,0.7211764705882353
Georgia,13201,159,37,122,0.6224489795918368
Georgia,13205,1338,203,1135,0.736534717715769
Georgia,13207,1250,300,950,0.6129032258064516
Georgia,13209,287,72,215,0.5988857938718662
Georgia,13211,910,259,651,0.5568862275449101
Georgia,13213,444,407,37,0.043478260869565216
Georgia,13215,12801,3319,9482,0.5882133995037221
Georgia,13217,7269,2001,5268,0.568284789644013
Georgia,13219,1223,1098,125,0.05385609651012495
Georgia,13221,561,358,203,0.22089227421109903
Georgia,13223,4095,2111,1984,0.31969062197873027
Georgia,13225,1675,316,1359,0.6825715720743345
Georgia,13227,431,370,61,0.07615480649188515
Georgia,13229,219,104,115,0.3560371517027864
Georgia,13231,417,187,230,0.38079470198675497
Georgia,13233,944,403,541,0.4016332590942836
Georgia,13235,376,60,316,0.7247706422018348
Georgia,13237,871,206,665,0.617455896007428
Georgia,13239,193,15,178,0.8557692307692307
Georgia,13241,397,326,71,0.09820193637621023
Georgia,13243,690,71,619,0.8134034165571616
Georgia,13245,16269,3578,12691,0.6394417292285988
Georgia,13247,7930,2212,5718,0.5637941234470518
Georgia,13249,146,25,121,0.7076023391812866
Georgia,13251,771,166,605,0.6456776947705443
Georgia,13253,470,81,389,0.705989110707804
Georgia,13255,3129,820,2309,0.5847049886047101
Georgia,13257,460,284,176,0.23655913978494625
Georgia,13259,460,46,414,0.8181818181818182
Georgia,13261,1960,404,1556,0.6582064297800339
Georgia,13263,852,120,732,0.7530864197530864
Georgia,13265,236,35,201,0.7416974169741697
Georgia,13267,518,153,365,0.5439642324888226
Georgia,13269,476,62,414,0.7695167286245354
Georgia,13271,426,91,335,0.6479690522243714
Georgia,13273,804,105,699,0.768976897689769
Georgia,13275,2053,551,1502,0.5768049155145929
Georgia,13277,1151,344,807,0.539799331103679
Georgia,13279,562,166,396,0.5439560439560439
Georgia,13281,312,266,46,0.07958477508650519
Georgia,13283,300,58,242,0.6759776536312849
Georgia,13285,3357,850,2507,0.5959115759448538
Georgia,13287,330,81,249,0.6058394160583942
Georgia,13289,818,118,700,0.7478632478632479
Georgia,13291,573,417,156,0.15757575757575756
Georgia,13293,1236,280,956,0.6306068601583114
Georgia,13295,1009,867,142,0.07569296375266525
Georgia,13297,2309,969,1340,0.40878584502745574
Georgia,13299,919,284,635,0.5278470490440565
Georgia,13301,468,49,419,0.8104448742746615
Georgia,13303,1741,256,1485,0.7436154231347021
Georgia,13305,700,236,464,0.49572649572649574
Georgia,13307,170,18,152,0.8085106382978723
Georgia,13309,177,26,151,0.7438423645320197
Georgia,13311,498,440,58,0.06183368869936034
Georgia,13313,1536,1307,229,0.08054871614491733
Georgia,13315,302,41,261,0.760932944606414
Georgia,13317,702,141,561,0.6654804270462633
Georgia,13319,832,155,677,0.6859169199594731
Georgia,13321,684,166,518,0.6094117647058823
Hawaii,15001,1639,5605,-3966,-0.5474875759249034
Hawaii,15003,6686,11458,-4772,-0.2630070546737213
Hawaii,15007,607,2049,-1442,-0.5429216867469879
Hawaii,15009,1195,4419,-3224,-0.5742785892411828
Idaho,16001,1663,7336,-5673,-0.6304033781531281
Idaho,16003,19,48,-29,-0.43283582089552236
Idaho,16005,301,1197,-896,-0.5981308411214953
Idaho,16007,12,25,-13,-0.35135135135135137
Idaho,16009,20,49,-29,-0.42028985507246375
Idaho,16011,55,181,-126,-0.5338983050847458
Idaho,16013,249,539,-290,-0.3680203045685279
Idaho,16015,36,76,-40,-0.35714285714285715
Idaho,16017,185,716,-531,-0.5893451720310766
Idaho,16019,217,822,-605,-0.5822906641000962
Idaho,16021,27,158,-131,-0.7081081081081081
Idaho,16023,5,20,-15,-0.6
Idaho,16025,7,11,-4,-0.2222222222222222
Idaho,16027,278,1312,-1034,-0.650314465408805
Idaho,16029,3,7,-4,-0.4
Idaho,16031,36,57,-21,-0.22580645161290322
Idaho,16033,0,4,-4,-1.0
Idaho,16035,38,53,-15,-0.16483516483516483
Idaho,16037,12,31,-19,-0.4418604651162791
Idaho,16039,77,156,-79,-0.33905579399141633
Idaho,16041,25,36,-11,-0.18032786885245902
Idaho,16043,5,24,-19,-0.6551724137931034
Idaho,16045,50,131,-81,-0.44751381215469616
Idaho,16047,28,49,-21,-0.2727272727272727
Idaho,16049,48,90,-42,-0.30434782608695654
Idaho,16051,24,101,-77,-0.616
Idaho,16053,32,107,-75,-0.539568345323741
Idaho,16055,493,1561,-1068,-0.5199610516066212
Idaho,16057,310,1612,-1302,-0.6774193548387096
Idaho,16059,17,71,-54,-0.6136363636363636
Idaho,16061,20,19,1,0.02564102564102564
Idaho,16063,15,22,-7,-0.1891891891891892
Idaho,16065,47,216,-169,-0.6425855513307985
Idaho,16067,26,51,-25,-0.3246753246753247
Idaho,16069,155,383,-228,-0.42379182156133827
Idaho,16071,5,6,-1,-0.09090909090909091
Idaho,16073,22,40,-18,-0.2903225806451613
Idaho,16075,46,91,-45,-0.3284671532846715
Idaho,16077,19,45,-26,-0.40625
Idaho,16079,45,85,-40,-0.3076923076923077
Idaho,16081,84,311,-227,-0.5746835443037974
Idaho,16083,201,522,-321,-0.44398340248962653
Idaho,16085,73,198,-125,-0.4612546125461255
Idaho,16087,35,71,-36,-0.33962264150943394
Illinois,17001,1731,1609,122,0.03652694610778443
Illinois,17003,770,434,336,0.27906976744186046
Illinois,17005,718,858,-140,-0.08883248730964467
Illinois,17007,1957,2773,-816,-0.17251585623678647
Illinois,17009,160,156,4,0.012658227848101266
Illinois,17011,1518,1852,-334,-0.09910979228486647
Illinois,17013,446,503,-57,-0.06006322444678609
Illinois,17015,625,640,-15,-0.011857707509881422
Illinois,17017,504,539,-35,-0.03355704697986577
Illinois,17019,10542,20581,-10039,-0.32255887928541593
Illinois,17021,1395,1526,-131,-0.04484765491270113
Illinois,17023,560,664,-104,-0.08496732026143791
Illinois,17025,378,439,-61,-0.07466340269277846
Illinois,17027,906,1266,-360,-0.16574585635359115
Illinois,17029,1708,2522,-814,-0.19243498817966903
Illinois,17031,611378,519549,91829,0.08119799067490652
Illinois,17033,609,583,26,0.02181208053691275
Illinois,17035,364,517,-153,-0.17366628830874006
Illinois,17037,4135,8315,-4180,-0.3357429718875502
Illinois,17039,561,659,-98,-0.08032786885245902
Illinois,17041,483,643,-160,-0.14209591474245115
Illinois,17043,59103,65159,-6056,-0.048735735784069145
Illinois,17045,446,468,-22,-0.024070021881838075
Illinois,17047,143,148,-5,-0.01718213058419244
Illinois,17049,867,1247,-380,-0.17975402081362346
Illinois,17051,616,641,-25,-0.01988862370723946
Illinois,17053,288,438,-150,-0.2066115702479339
Illinois,17055,2172,2780,-608,-0.12277867528271405
Illinois,17057,2150,2537,-387,-0.08256880733944955
Illinois,17059,531,663,-132,-0.11055276381909548
Illinois,17061,503,530,-27,-0.026137463697967087
Illinois,17063,2051,3095,-1044,-0.20287602020987175
Illinois,17065,418,485,-67,-0.07419712070874862
Illinois,17067,607,431,176,0.16955684007707128
Illinois,17069,162,222,-60,-0.15625
Illinois,17071,338,296,42,0.06624605678233439
Illinois,17073,2156,2056,100,0.023741690408357077
Illinois,17075,542,875,-333,-0.23500352858151025
Illinois,17077,2826,4656,-1830,-0.24458700882117082
Illinois,17079,328,434,-106,-0.13910761154855644
Illinois,17081,1677,1775,-98,-0.028389339513325607
Illinois,17083,853,1069,-216,-0.11238293444328824
Illinois,17085,1315,1225,90,0.03543307086614173
Illinois,17087,361,420,-59,-0.07554417413572344
Illinois,17089,24063,31085,-7022,-0.12733009356640312
Illinois,17091,4898,5751,-853,-0.08010141797351863
Illinois,17093,5283,7482,-2199,-0.17226792009400704
Illinois,17095,2836,3168,-332,-0.0552964690206529
Illinois,17097,49750,44355,5395,0.05732957866213272
Illinois,17099,5271,6739,-1468,-0.12223147377185678
Illinois,17101,417,429,-12,-0.014184397163120567
Illinois,17103,1292,1958,-666,-0.20492307692307693
Illinois,17105,757,971,-214,-0.12384259259259259
Illinois,17107,737,972,-235,-0.13750731421884144
Illinois,17109,1052,1469,-417,-0.16541055136850455
Illinois,17111,9766,15502,-5736,-0.227006490422669
Illinois,17113,7695,12936,-5241,-0.25403518976297806
Illinois,17115,5945,4990,955,0.08733424782807499
Illinois,17117,2770,3552,-782,-0.12369503321733628
Illinois,17119,15332,18723,-3391,-0.09957421817647923
Illinois,17121,1609,1681,-72,-0.02188449848024316
Illinois,17123,568,586,-18,-0.01559792027729636
Illinois,17125,680,676,4,0.0029498525073746312
Illinois,17127,539,492,47,0.04558680892337536
Illinois,17129,398,491,-93,-0.1046119235095613
Illinois,17131,946,859,87,0.0481994459833795
Illinois,17133,1436,1775,-339,-0.10557458735596388
Illinois,17135,1241,1266,-25,-0.00997207818109294
Illinois,17137,917,1278,-361,-0.16446469248291573
Illinois,17139,462,566,-104,-0.10116731517509728
Illinois,17141,1793,2642,-849,-0.19143179255918827
Illinois,17143,11341,10345,996,0.045928248639675366
Illinois,17145,853,930,-77,-0.04318564217610768
Illinois,17147,787,1016,-229,-0.12701053799223516
Illinois,17149,495,451,44,0.046511627906976744
Illinois,17151,109,176,-67,-0.23508771929824562
Illinois,17153,285,158,127,0.2866817155756208
Illinois,17155,450,504,-54,-0.05660377358490566
Illinois,17157,1306,1549,-243,-0.0851138353765324
Illinois,17159,448,543,-95,-0.0958627648839556
Illinois,17161,10216,9327,889,0.04548943355677225
Illinois,17163,20987,15565,5422,0.14833661632742395
Illinois,17165,1042,1150,-108,-0.04927007299270073
Illinois,17167,9255,10365,-1110,-0.05657492354740061
Illinois,17169,368,293,75,0.11346444780635401
Illinois,17171,150,161,-11,-0.03536977491961415
Illinois,17173,782,940,-158,-0.09175377468060394
Illinois,17175,197,215,-18,-0.043689320388349516
Illinois,17177,1953,1899,54,0.014018691588785047
Illinois,17179,5867,7154,-1287,-0.098840334843714
Illinois,17181,921,1152,-231,-0.11143270622286541
Illinois,17183,3017,2781,236,0.040703690927906176
Illinois,17185,356,343,13,0.01859799713876967
Illinois,17187,726,741,-15,-0.010224948875255624
Illinois,17189,409,595,-186,-0.1852589641434263
Illinois,17191,277,360,-83,-0.130298273155416
Illinois,17193,565,530,35,0.0319634703196347
Illinois,17195,2895,3102,-207,-0.03451725862931466
Illinois,17197,41651,46305,-4654,-0.05291282004638683
Illinois,17199,2978,3902,-924,-0.13430232558139535
Illinois,17201,15065,16715,-1650,-0.051919446192573944
Illinois,17203,1277,1616,-339,-0.11717939854821983
Indiana,18001,991,1030,-39,-0.01929737753587333
Indiana,18003,15032,16435,-1403,-0.044586392093304096
Indiana,18005,2778,3182,-404,-0.06778523489932886
Indiana,18007,190,235,-45,-0.10588235294117647
Indiana,18009,493,514,-21,-0.020854021847070508
Indiana,18011,2075,2555,-480,-0.10367170626349892
Indiana,18013,805,1269,-464,-0.22372227579556414
Indiana,18015,508,648,-140,-0.12110726643598616
Indiana,18017,1137,1655,-518,-0.18553008595988538
Indiana,18019,6192,5305,887,0.07715056101591719
Indiana,18021,931,1049,-118,-0.0595959595959596
Indiana,18023,724,1046,-322,-0.18192090395480226
Indiana,18025,684,616,68,0.052307692307692305
Indiana,18027,539,701,-162,-0.13064516129032258
Indiana,18029,1389,1245,144,0.05466970387243736
Indiana,18031,631,733,-102,-0.0747800586510264
Indiana,18033,1139,1269,-130,-0.05398671096345515
Indiana,18035,6137,7728,-1591,-0.114749368914533
Indiana,18037,2305,2293,12,0.0026098303610265334
Indiana,18039,4788,6935,-2147,-0.18314424635332252
Indiana,18041,984,1097,-113,-0.05430081691494474
Indiana,18043,4584,4108,476,0.05476300046019328
Indiana,18045,413,462,-49,-0.056
Indiana,18047,667,552,115,0.09433962264150944
Indiana,18049,594,683,-89,-0.0696945967110415
Indiana,18051,1484,1453,31,0.010554988083077971
Indiana,18053,2318,2344,-26,-0.005577005577005577
Indiana,18055,1086,1464,-378,-0.14823529411764705
Indiana,18057,12297,14557,-2260,-0.08415878453861622
Indiana,18059,1793,2600,-807,-0.1837013430457546
Indiana,18061,1887,1627,260,0.07398975526465566
Indiana,18063,4873,6898,-2025,-0.17203296236513466
Indiana,18065,1789,2139,-350,-0.08910386965376782
Indiana,18067,3526,3733,-207,-0.02851632456261193
Indiana,18069,836,1227,-391,-0.18952981095492002
Indiana,18071,1467,1380,87,0.030558482613277135
Indiana,18073,910,1323,-413,-0.18495297805642633
Indiana,18075,692,704,-12,-0.008595988538681949
Indiana,18077,1648,1465,183,0.05878573723096691
Indiana,18079,837,921,-84,-0.04778156996587031
Indiana,18081,3686,5480,-1794,-0.19572332533275147
Indiana,18083,1742,1774,-32,-0.009101251422070534
Indiana,18085,1373,2120,-747,-0.21385628399656456
Indiana,18087,521,578,-57,-0.051865332120109194
Indiana,18089,43091,32893,10198,0.13421246578226995
Indiana,18091,6178,7273,-1095,-0.08140658687086462
Indiana,18093,1062,1648,-586,-0.21623616236162363
Indiana,18095,6635,7170,-535,-0.038754074610648316
Indiana,18097,59649,58799,850,0.007176144806159665
Indiana,18099,1202,1705,-503,-0.17303061575507395
Indiana,18101,407,486,-79,-0.08846584546472565
Indiana,18103,720,987,-267,-0.15641476274165203
Indiana,18105,8063,15166,-7103,-0.30578156614576607
Indiana,18107,715,966,-251,-0.14931588340273647
Indiana,18109,1600,2158,-558,-0.1484832357637041
Indiana,18111,434,521,-87,-0.09109947643979058
Indiana,18113,1134,1274,-140,-0.05813953488372093
Indiana,18115,248,178,70,0.1643192488262911
Indiana,18117,603,661,-58,-0.04588607594936709
Indiana,18119,631,1056,-425,-0.25192649673977474
Indiana,18121,392,539,-147,-0.15789473684210525
Indiana,18123,1358,1114,244,0.09870550161812297
Indiana,18125,526,625,-99,-0.08601216333622937
Indiana,18127,9466,13344,-3878,-0.17001315212626042
Indiana,18129,1117,1378,-261,-0.10460921843687375
Indiana,18131,351,473,-122,-0.14805825242718446
Indiana,18133,974,1189,-215,-0.09939898289412853
Indiana,18135,705,887,-182,-0.114321608040201
Indiana,18137,674,690,-16,-0.011730205278592375
Indiana,18139,417,561,-144,-0.147239263803681
Indiana,18141,15514,17355,-1841,-0.0560102223980042
Indiana,18143,1588,1288,300,0.1043115438108484
Indiana,18145,1215,1497,-282,-0.10398230088495575
Indiana,18147,1060,1030,30,0.014354066985645933
Indiana,18149,1055,1277,-222,-0.09519725557461406
Indiana,18151,981,1120,-139,-0.06615897191813422
Indiana,18153,1058,1454,-396,-0.15764331210191082
Indiana,18155,430,410,20,0.023809523809523808
Indiana,18157,5998,9580,-3582,-0.22993965849274617
Indiana,18159,437,606,-169,-0.16203259827420902
Indiana,18161,205,205,0,0.0
Indiana,18163,7679,9132,-1453,-0.08643150318244007
Indiana,18165,1074,1309,-235,-0.09861519093579521
Indiana,18167,6042,7434,-1392,-0.10329474621549421
Indiana,18169,906,1080,-174,-0.08761329305135952
Indiana,18171,257,273,-16,-0.03018867924528302
Indiana,18173,2677,3139,-462,-0.07943603851444292
Indiana,18175,999,932,67,0.03469704816157431
Indiana,18177,2025,2411,-386,-0.08701532912533815
Indiana,18179,763,796,-33,-0.021167415009621552
Indiana,18181,709,912,-203,-0.12523133867982728
Indiana,18183,883,1143,-260,-0.12833168805528133
Iowa,19001,168,132,36,0.12
Iowa,19003,113,86,27,0.135678391959799
Iowa,19005,304,296,8,0.013333333333333334
Iowa,19007,273,226,47,0.09418837675350701
Iowa,19009,187,112,75,0.2508361204013378
Iowa,19011,672,528,144,0.12
Iowa,19013,3220,3647,-427,-0.06218144750254842
Iowa,19015,585,715,-130,-0.1
Iowa,19017,640,544,96,0.08108108108108109
Iowa,19019,525,475,50,0.05
Iowa,19021,291,291,0,0.0
Iowa,19023,250,350,-100,-0.16666666666666666
Iowa,19025,200,200,0,0.0
Iowa,19027,504,296,208,0.26
Iowa,19029,300,190,110,0.22448979591836735
Iowa,19031,354,445,-91,-0.11389236545682102
Iowa,19033,1091,1108,-17,-0.007730786721236926
Iowa,19035,181,218,-37,-0.09273182957393483
Iowa,19037,360,233,127,0.21416526138279932
Iowa,19039,232,168,64,0.16
Iowa,19041,296,303,-7,-0.011686143572621035
Iowa,19043,392,408,-16,-0.02
Iowa,19045,1165,1234,-69,-0.028761984160066693
Iowa,19047,225,208,17,0.03926096997690531
Iowa,19049,1667,1208,459,0.15965217391304348
Iowa,19051,174,126,48,0.16
Iowa,19053,150,141,9,0.030927835051546393
Iowa,19055,440,344,96,0.12244897959183673
Iowa,19057,933,1066,-133,-0.06653326663331666
Iowa,19059,341,358,-17,-0.024320457796852647
Iowa,19061,2504,2276,228,0.04769874476987448
Iowa,19063,168,132,36,0.12
Iowa,19065,525,468,57,0.05740181268882175
Iowa,19067,453,346,107,0.13391739674593242
Iowa,19069,226,168,58,0.14720812182741116
Iowa,19071,120,135,-15,-0.058823529411764705
Iowa,19073,215,184,31,0.07769423558897243
Iowa,19075,186,206,-20,-0.05102040816326531
Iowa,19077,220,180,40,0.1
Iowa,19079,353,246,107,0.17863105175292154
Iowa,19081,240,152,88,0.22448979591836735
Iowa,19083,403,296,107,0.1530758226037196
Iowa,19085,226,273,-47,-0.09418837675350701
Iowa,19087,350,350,0,0.0
Iowa,19089,184,215,-31,-0.07769423558897243
Iowa,19091,166,133,33,0.11036789297658862
Iowa,19093,106,93,13,0.06532663316582915
Iowa,19095,357,343,14,0.02
Iowa,19097,450,414,36,0.041666666666666664
Iowa,19099,927,810,117,0.06735751295336788
Iowa,19101,245,654,-409,-0.4549499443826474
Iowa,19103,3700,5473,-1773,-0.1932846397034776
Iowa,19105,419,480,-61,-0.067853170189099
Iowa,19107,250,140,110,0.28205128205128205
Iowa,19109,360,213,147,0.25654450261780104
Iowa,19111,929,770,159,0.09358446144791054
Iowa,19113,5733,6331,-598,-0.04956896551724138
Iowa,19115,224,168,56,0.14285714285714285
Iowa,19117,180,120,60,0.2
Iowa,19119,80,113,-33,-0.17098445595854922
Iowa,19121,320,280,40,0.06666666666666667
Iowa,19123,393,306,87,0.12446351931330472
Iowa,19125,650,624,26,0.02040816326530612
Iowa,19127,839,960,-121,-0.06725958866036687
Iowa,19129,255,244,11,0.022044088176352707
Iowa,19131,260,135,125,0.31645569620253167
Iowa,19133,180,116,64,0.21621621621621623
Iowa,19135,129,133,-4,-0.015267175572519083
Iowa,19137,108,192,-84,-0.28
Iowa,19139,828,972,-144,-0.08
Iowa,19141,152,141,11,0.03754266211604096
Iowa,19143,56,38,18,0.19148936170212766
Iowa,19145,197,202,-5,-0.012531328320802004
Iowa,19147,213,186,27,0.06766917293233082
Iowa,19149,387,312,75,0.1072961373390558
Iowa,19151,198,90,108,0.375
Iowa,19153,12122,10526,1596,0.07046979865771812
Iowa,19155,1519,1573,-54,-0.017464424320827943
Iowa,19157,424,475,-51,-0.05672969966629588
Iowa,19159,132,67,65,0.32663316582914576
Iowa,19161,165,135,30,0.1
Iowa,19163,4025,4144,-119,-0.01456726649528706
Iowa,19165,168,232,-64,-0.16
Iowa,19167,192,202,-10,-0.025380710659898477
Iowa,19169,1862,2737,-875,-0.1902587519025875
Iowa,19171,476,423,53,0.058954393770856504
Iowa,19173,140,60,80,0.4
Iowa,19175,231,268,-37,-0.07414829659318638
Iowa,19177,93,106,-13,-0.06532663316582915
Iowa,19179,817,667,150,0.10107816711590296
Iowa,19181,1217,953,264,0.12165898617511521
Iowa,19183,484,415,69,0.07675194660734148
Iowa,19185,130,70,60,0.3
Iowa,19187,866,720,146,0.09205548549810845
Iowa,19189,170,230,-60,-0.15
Iowa,19191,484,616,-132,-0.12
Iowa,19193,1665,1920,-255,-0.07112970711297072
Iowa,19195,181,218,-37,-0.09273182957393483
Iowa,19197,273,226,47,0.09418837675350701
Kansas,20000,12593,26450,-13857,-0.354916374
Kentucky,21001,466,410,56,0.0639269406392694
Kentucky,21003,427,440,-13,-0.014994232987312572
Kentucky,21005,1132,1649,-517,-0.18590435095289465
Kentucky,21007,405,659,-254,-0.2387218045112782
Kentucky,21009,1979,2653,-674,-0.14550949913644215
Kentucky,21011,628,641,-13,-0.01024428684003152
Kentucky,21013,567,578,-11,-0.00960698689956332
Kentucky,21015,2932,2496,436,0.08032424465733234
Kentucky,21017,1109,1087,22,0.010018214936247723
Kentucky,21019,2193,2262,-69,-0.015488215488215488
Kentucky,21021,1648,1451,197,0.06356889319135205
Kentucky,21023,251,424,-173,-0.2562962962962963
Kentucky,21025,1123,1716,-593,-0.2088763649172244
Kentucky,21027,877,875,2,0.001141552511415525
Kentucky,21029,2907,3210,-303,-0.049534085335948996
Kentucky,21031,238,196,42,0.0967741935483871
Kentucky,21033,570,866,-296,-0.20612813370473537
Kentucky,21035,1460,2239,-779,-0.21059745877264124
Kentucky,21037,3169,3133,36,0.005712472231037766
Kentucky,21039,206,462,-256,-0.38323353293413176
Kentucky,21041,481,573,-92,-0.0872865275142315
Kentucky,21043,800,1051,-251,-0.13560237709346298
Kentucky,21045,210,182,28,0.07142857142857142
Kentucky,21047,2437,1936,501,0.11456665904413446
Kentucky,21049,1810,1888,-78,-0.021092482422931314
Kentucky,21051,184,158,26,0.07602339181286549
Kentucky,21053,151,93,58,0.23770491803278687
Kentucky,21055,240,344,-104,-0.1780821917808219
Kentucky,21057,78,87,-9,-0.05454545454545454
Kentucky,21059,5066,5188,-122,-0.011897795982055783
Kentucky,21061,275,262,13,0.024208566108007448
Kentucky,21063,301,443,-142,-0.19086021505376344
Kentucky,21065,446,440,6,0.006772009029345372
Kentucky,21067,20014,17048,2966,0.08002806108682747
Kentucky,21069,627,806,-179,-0.12491277041172366
Kentucky,21071,2327,4010,-1683,-0.2655830834779864
Kentucky,21073,5218,5398,-180,-0.016955538809344386
Kentucky,21075,315,245,70,0.125
Kentucky,21077,260,340,-80,-0.13333333333333333
Kentucky,21079,434,387,47,0.057247259439707675
Kentucky,21081,594,715,-121,-0.09243697478991597
Kentucky,21083,1631,2631,-1000,-0.2346316283435007
Kentucky,21085,705,630,75,0.056179775280898875
Kentucky,21087,284,360,-76,-0.11801242236024845
Kentucky,21089,1517,1655,-138,-0.043505674653215635
Kentucky,21091,491,573,-82,-0.07706766917293233
Kentucky,21093,4359,4208,151,0.017625773316213376
Kentucky,21095,451,1092,-641,-0.4154244977316915
Kentucky,21097,886,1059,-173,-0.08894601542416453
Kentucky,21099,817,1062,-245,-0.1303885045236828
Kentucky,21101,2887,2850,37,0.00644936377897856
Kentucky,21103,781,958,-177,-0.10178263369752731
Kentucky,21105,209,300,-91,-0.1787819253438114
Kentucky,21107,1690,2696,-1006,-0.22936616507067945
Kentucky,21109,78,128,-50,-0.24271844660194175
Kentucky,21111,64090,45048,19042,0.1744763510418003
Kentucky,21113,1875,2113,-238,-0.059679037111334
Kentucky,21115,444,749,-305,-0.25565800502933783
Kentucky,21117,5146,4880,266,0.026531019349690804
Kentucky,21119,583,1114,-531,-0.3129051266941662
Kentucky,21121,520,504,16,0.015625
Kentucky,21123,612,910,-298,-0.19579500657030224
Kentucky,21125,845,791,54,0.03300733496332518
Kentucky,21127,444,659,-215,-0.19492293744333636
Kentucky,21129,199,224,-25,-0.0591016548463357
Kentucky,21131,64,77,-13,-0.09219858156028368
Kentucky,21133,838,1788,-950,-0.3617669459253618
Kentucky,21135,211,151,60,0.16574585635359115
Kentucky,21137,779,742,37,0.024326101249178174
Kentucky,21139,400,610,-210,-0.2079207920792079
Kentucky,21141,1077,1131,-54,-0.024456521739130436
Kentucky,21143,497,561,-64,-0.06049149338374291
Kentucky,21145,3334,3541,-207,-0.03010909090909091
Kentucky,21147,169,203,-34,-0.0913978494623656
Kentucky,21149,477,628,-151,-0.13665158371040723
Kentucky,21151,3441,4385,-944,-0.1206235624840276
Kentucky,21153,511,626,-115,-0.1011433597185576
Kentucky,21155,1162,983,179,0.08344988344988345
Kentucky,21157,1577,2308,-731,-0.18815958815958816
Kentucky,21159,104,191,-87,-0.29491525423728815
Kentucky,21161,727,775,-48,-0.03195739014647137
Kentucky,21163,1312,1541,-229,-0.08026638626007711
Kentucky,21165,311,323,-12,-0.01892744479495268
Kentucky,21167,988,1331,-343,-0.14790858128503664
Kentucky,21169,506,582,-76,-0.06985294117647059
Kentucky,21171,126,109,17,0.07234042553191489
Kentucky,21173,1289,1322,-33,-0.012638835695135964
Kentucky,21175,544,988,-444,-0.2898172323759791
Kentucky,21177,1544,1632,-88,-0.027707808564231738
Kentucky,21179,2395,2345,50,0.010548523206751054
Kentucky,21181,353,420,-67,-0.08667529107373868
Kentucky,21183,778,943,-165,-0.09587449157466589
Kentucky,21185,2730,2315,415,0.08225966303270565
Kentucky,21187,453,720,-267,-0.22762148337595908
Kentucky,21189,77,91,-14,-0.08333333333333333
Kentucky,21191,388,546,-158,-0.16916488222698073
Kentucky,21193,839,1666,-827,-0.33013972055888224
Kentucky,21195,2335,4848,-2513,-0.3498538215230405
Kentucky,21197,623,744,-121,-0.08851499634235552
Kentucky,21199,1169,1148,21,0.00906344410876133
Kentucky,21201,95,177,-82,-0.3014705882352941
Kentucky,21203,238,254,-16,-0.032520325203252036
Kentucky,21205,1170,1363,-193,-0.07619423608369523
Kentucky,21207,343,332,11,0.016296296296296295
Kentucky,21209,2505,2394,111,0.0226576852418861
Kentucky,21211,2195,2044,151,0.035621608870016516
Kentucky,21213,708,695,13,0.009265858873841768
Kentucky,21215,673,806,-133,-0.08992562542258282
Kentucky,21217,949,844,105,0.05856107083100948
Kentucky,21219,333,507,-174,-0.20714285714285716
Kentucky,21221,604,715,-111,-0.0841546626231994
Kentucky,21223,415,542,-127,-0.13270637408568442
Kentucky,21225,672,1106,-434,-0.2440944881889764
Kentucky,21227,4829,5365,-536,-0.05257994898960173
Kentucky,21229,601,582,19,0.016060862214708368
Kentucky,21231,502,356,146,0.17016317016317017
Kentucky,21233,693,1169,-476,-0.2556390977443609
Kentucky,21235,522,409,113,0.12137486573576799
Kentucky,21237,414,499,-85,-0.09309967141292443
Kentucky,21239,1862,1918,-56,-0.014814814814814815
Louisiana,22001,1862,1087,775,0.2628009494743981
Louisiana,22003,536,297,239,0.28691476590636256
Louisiana,22005,4221,1384,2837,0.5061552185548618
Louisiana,22007,1139,312,827,0.5699517574086836
Louisiana,22009,1181,455,726,0.44376528117359415
Louisiana,22011,679,391,288,0.2691588785046729
Louisiana,22013,1056,222,834,0.6525821596244131
Louisiana,22015,2919,1187,1732,0.4218217243058938
Louisiana,22017,16666,3513,13153,0.651816244610734
Louisiana,22019,6594,2625,3969,0.4305239179954442
Louisiana,22021,250,119,131,0.35501355013550134
Louisiana,22023,123,132,-9,-0.03529411764705882
Louisiana,22025,431,194,237,0.3792
Louisiana,22027,768,158,610,0.6587473002159827
Louisiana,22029,1830,329,1501,0.6952292728114868
Louisiana,22031,1508,318,1190,0.651697699890471
Louisiana,22033,32960,7970,24990,0.6105546054238945
Louisiana,22035,508,47,461,0.8306306306306306
Louisiana,22037,1847,347,1500,0.6836827711941659
Louisiana,22039,1319,498,821,0.4518436984039626
Louisiana,22041,650,218,432,0.4976958525345622
Louisiana,22043,367,247,120,0.19543973941368079
Louisiana,22045,2171,806,1365,0.4585152838427948
Louisiana,22047,3699,1042,2657,0.560430288968572
Louisiana,22049,827,267,560,0.5118829981718465
Louisiana,22051,17581,7024,10557,0.4290591343222922
Louisiana,22053,738,418,320,0.2768166089965398
Louisiana,22055,5920,3523,2397,0.253838822408133
Louisiana,22057,2512,1789,723,0.16810044175773076
Louisiana,22059,136,184,-48,-0.15
Louisiana,22061,1692,436,1256,0.5902255639097744
Louisiana,22063,1633,1392,241,0.07966942148760331
Louisiana,22065,722,98,624,0.7609756097560976
Louisiana,22067,1513,298,1215,0.6709000552181116
Louisiana,22069,2545,846,1699,0.5010321439103509
Louisiana,22071,40601,13086,27515,0.5125076834242926
Louisiana,22073,8995,1803,7192,0.6660492683830339
Louisiana,22075,674,214,460,0.5180180180180181
Louisiana,22077,1680,352,1328,0.6535433070866141
Louisiana,22079,4722,1451,3271,0.5298882229062044
Louisiana,22081,530,117,413,0.6383307573415765
Louisiana,22083,696,135,561,0.6750902527075813
Louisiana,22085,387,259,128,0.19814241486068113
Louisiana,22087,1057,527,530,0.3345959595959596
Louisiana,22089,2245,787,1458,0.4808707124010554
Louisiana,22091,1407,186,1221,0.7664783427495292
Louisiana,22093,2114,324,1790,0.734208367514356
Louisiana,22095,3818,564,3254,0.7425832952989503
Louisiana,22097,4606,1184,3422,0.5910189982728843
Louisiana,22099,1869,690,1179,0.46072684642438455
Louisiana,22101,1995,535,1460,0.5770750988142292
Louisiana,22103,5996,3800,2196,0.2241731318905676
Louisiana,22105,4267,1656,2611,0.4408239068039845
Louisiana,22107,492,61,431,0.779385171790235
Louisiana,22109,2647,1023,1624,0.4425068119891008
Louisiana,22111,822,217,605,0.5822906641000962
Louisiana,22113,1002,648,354,0.21454545454545454
Louisiana,22115,610,441,169,0.16079923882017128
Louisiana,22117,1663,513,1150,0.5284926470588235
Louisiana,22119,1878,436,1442,0.6231633535004322
Louisiana,22121,2178,589,1589,0.5742681604625949
Louisiana,22123,171,110,61,0.21708185053380782
Louisiana,22125,902,166,736,0.6891385767790262
Louisiana,22127,488,193,295,0.4331864904552129
Maine,23001,76,139,-63,-0.2930232558139535
Maine,23003,73,89,-16,-0.09876543209876543
Maine,23005,346,597,-251,-0.26617179215270415
Maine,23007,18,45,-27,-0.42857142857142855
Maine,23009,51,101,-50,-0.32894736842105265
Maine,23011,129,190,-61,-0.19122257053291536
Maine,23013,37,79,-42,-0.3620689655172414
Maine,23015,29,59,-30,-0.3409090909090909
Maine,23017,32,83,-51,-0.4434782608695652
Maine,23019,119,231,-112,-0.32
Maine,23021,14,26,-12,-0.3
Maine,23023,40,69,-29,-0.26605504587155965
Maine,23025,41,67,-26,-0.24074074074074073
Maine,23027,27,74,-47,-0.46534653465346537
Maine,23029,22,51,-29,-0.3972602739726027
Maine,23031,160,301,-141,-0.30585683297180044
Maryland,24001,2311,2469,-158,-0.03305439330543933
Maryland,24003,35659,24128,11531,0.192868014785823
Maryland,24005,73099,46779,26320,0.21955654915831094
Maryland,24009,5168,3247,1921,0.22828282828282828
Maryland,24011,1125,902,223,0.11001480019733596
Maryland,24013,6516,6686,-170,-0.01287683684290259
Maryland,24015,3367,3350,17,0.0025308917671579573
Maryland,24017,15132,6246,8886,0.41566095986528206
Maryland,24019,1800,951,849,0.30861504907306436
Maryland,24021,13466,11324,2142,0.0864058087938685
Maryland,24023,760,879,-119,-0.0726052471018914
Maryland,24025,13460,10817,2643,0.10886847633562631
Maryland,24027,30873,18752,12121,0.24425188916876575
Maryland,24029,1460,1018,442,0.17836965294592413
Maryland,24031,109304,50741,58563,0.36591583617107687
Maryland,24033,113912,37199,76713,0.5076599321028913
Maryland,24035,2342,1759,583,0.14216044867105584
Maryland,24037,4551,3415,1136,0.14260607582224455
Maryland,24039,1136,533,603,0.36129418813660874
Maryland,24041,2577,1445,1132,0.2814520139234212
Maryland,24043,5851,4867,984,0.09180817316663557
Maryland,24045,5258,3119,2139,0.2553420078787155
Maryland,24047,3005,1939,1066,0.2156148867313916
Maryland,24510,81115,38710,42405,0.3538910911746297
Massachusetts,25001,21847,22393,-546,-0.012341772151898734
Massachusetts,25003,12616,13642,-1026,-0.03907380607814761
Massachusetts,25005,36751,36422,329,0.004496193951320842
Massachusetts,25007,2311,2802,-491,-0.09602972814394681
Massachusetts,25009,65391,66236,-845,-0.006419655541796136
Massachusetts,25011,5483,13276,-7793,-0.4154272615811077
Massachusetts,25013,31715,29644,2071,0.0337521797943252
Massachusetts,25015,14274,24516,-10242,-0.2640371229698376
Massachusetts,25017,169552,154032,15520,0.0479628164556962
Massachusetts,25019,979,1051,-72,-0.035467980295566505
Massachusetts,25021,71275,61203,10072,0.07602771780974954
Massachusetts,25023,39051,40082,-1031,-0.013028698520212807
Massachusetts,25025,79083,57872,21211,0.1548756890949582
Massachusetts,25027,53456,63545,-10089,-0.08623003222194682
Michigan,26001,463,455,8,0.008714596949891068
Michigan,26003,384,622,-238,-0.23658051689860835
Michigan,26005,3489,5545,-2056,-0.22758468009740979
Michigan,26007,1102,1347,-245,-0.1000408329930584
Michigan,26009,867,1491,-624,-0.26463104325699743
Michigan,26011,595,663,-68,-0.05405405405405406
Michigan,26013,270,371,-101,-0.15756630265210608
Michigan,26015,1736,3078,-1342,-0.2787702534275031
Michigan,26017,5937,6363,-426,-0.03463414634146342
Michigan,26019,853,1650,-797,-0.3184178985217739
Michigan,26021,6646,5952,694,0.0550881092236863
Michigan,26023,1010,1246,-236,-0.10460992907801418
Michigan,26025,5230,5810,-580,-0.05253623188405797
Michigan,26027,1657,1683,-26,-0.007784431137724551
Michigan,26029,1044,1730,-686,-0.247296322999279
Michigan,26031,1010,1318,-308,-0.1323024054982818
Michigan,26033,1230,1789,-559,-0.18516064922159656
Michigan,26035,1090,1239,-149,-0.0639759553456419
Michigan,26037,3409,4524,-1115,-0.14055212403882517
Michigan,26039,494,631,-137,-0.12177777777777778
Michigan,26041,1409,1705,-296,-0.09505459216441875
Michigan,26043,908,1075,-167,-0.08421583459404942
Michigan,26045,5560,7007,-1447,-0.11514283440757539
Michigan,26047,1369,2589,-1220,-0.3082364830722587
Michigan,26049,31284,28117,3167,0.053315600747462166
Michigan,26051,985,1083,-98,-0.047388781431334626
Michigan,26053,678,790,-112,-0.07629427792915532
Michigan,26055,4140,8091,-3951,-0.32303164091243564
Michigan,26057,1185,1812,-627,-0.2092092092092092
Michigan,26059,977,1380,-403,-0.17098005939753924
Michigan,26061,1109,2039,-930,-0.295425667090216
Michigan,26063,1050,1184,-134,-0.05998209489704566
Michigan,26065,18287,22909,-4622,-0.11219535877269637
Michigan,26067,1491,2812,-1321,-0.30699511968394144
Michigan,26069,1077,1202,-125,-0.054848617814831066
Michigan,26071,527,546,-19,-0.017707362534948742
Michigan,26073,2032,4024,-1992,-0.3289299867899604
Michigan,26075,5288,6804,-1516,-0.12537214687396625
Michigan,26077,12593,20146,-7553,-0.23070344237759247
Michigan,26079,590,987,-397,-0.2517438173747622
Michigan,26081,25899,43375,-17476,-0.252273580275428
Michigan,26083,128,188,-60,-0.189873417721519
Michigan,26085,548,514,34,0.032015065913371
Michigan,26087,3319,4650,-1331,-0.16702221106788806
Michigan,26089,1459,2359,-900,-0.2357255107386066
Michigan,26091,3455,4256,-801,-0.1038775774867073
Michigan,26093,6705,10435,-3730,-0.2176196032672112
Michigan,26095,167,291,-124,-0.27074235807860264
Michigan,26097,500,633,-133,-0.11738746690203
Michigan,26099,47597,46242,1355,0.014439625315700295
Michigan,26101,1120,1646,-526,-0.19016630513376717
Michigan,26103,3188,5530,-2342,-0.2686395962376692
Michigan,26105,1223,1741,-518,-0.1747638326585695
Michigan,26107,1173,1767,-594,-0.20204081632653062
Michigan,26109,835,805,30,0.018292682926829267
Michigan,26111,3097,4568,-1471,-0.19191128506197
Michigan,26113,399,591,-192,-0.19393939393939394
Michigan,26115,6716,6842,-126,-0.009293406107095442
Michigan,26117,1681,2762,-1081,-0.2433040738239928
Michigan,26119,392,383,9,0.011612903225806452
Michigan,26121,8220,10062,-1842,-0.10075484082704299
Michigan,26123,1290,2139,-849,-0.24759405074365703
Michigan,26125,92296,84158,8138,0.04611966858218006
Michigan,26127,791,1237,-446,-0.21992110453648916
Michigan,26129,862,926,-64,-0.035794183445190156
Michigan,26131,327,362,-35,-0.05079825834542816
Michigan,26133,670,953,-283,-0.17436845348120764
Michigan,26135,273,315,-42,-0.07142857142857142
Michigan,26137,786,1228,-442,-0.21946375372393248
Michigan,26139,7686,14334,-6648,-0.3019073569482289
Michigan,26141,592,606,-14,-0.011686143572621035
Michigan,26143,1163,1187,-24,-0.010212765957446808
Michigan,26145,12348,9619,2729,0.1242318022488278
Michigan,26147,3665,5165,-1500,-0.16987542468856173
Michigan,26149,1382,2219,-837,-0.2324354346014996
Michigan,26151,1160,1485,-325,-0.12287334593572778
Michigan,26153,312,345,-33,-0.0502283105022831
Michigan,26155,3031,4452,-1421,-0.18989710009354538
Michigan,26157,1984,2532,-548,-0.12134632418069087
Michigan,26159,2484,3656,-1172,-0.19087947882736156
Michigan,26161,30022,38063,-8041,-0.1181023720349563
Michigan,26163,163886,104999,58887,0.21900440708853228
Michigan,26165,909,1793,-884,-0.3271650629163583
Minnesota,27000,73510,118135,-44625,-0.232852409
Mississippi,28001,3013,438,2575,0.7461605331787887
Mississippi,28003,809,302,507,0.45634563456345634
Mississippi,28005,1212,127,1085,0.8103061986557132
Mississippi,28007,1519,195,1324,0.7724620770128354
Mississippi,28009,557,93,464,0.7138461538461538
Mississippi,28011,3029,493,2536,0.720045428733674
Mississippi,28013,748,120,628,0.7235023041474654
Mississippi,28015,828,82,746,0.8197802197802198
Mississippi,28017,1398,263,1135,0.6833232992173389
Mississippi,28019,517,93,424,0.6950819672131148
Mississippi,28021,1411,141,1270,0.8182989690721649
Mississippi,28023,1044,151,893,0.7472803347280335
Mississippi,28025,2372,351,2021,0.7421961072346677
Mississippi,28027,2301,442,1859,0.6777251184834123
Mississippi,28029,3373,411,2962,0.78276955602537
Mississippi,28031,1356,164,1192,0.7842105263157895
Mississippi,28033,5420,1940,3480,0.47282608695652173
Mississippi,28035,3708,1323,2385,0.4740608228980322
Mississippi,28037,701,120,581,0.707673568818514
Mississippi,28039,349,122,227,0.4819532908704883
Mississippi,28041,374,61,313,0.7195402298850575
Mississippi,28043,1634,245,1389,0.7392229909526343
Mississippi,28045,893,531,362,0.2542134831460674
Mississippi,28047,6886,2313,4573,0.49711925209261876
Mississippi,28049,31386,5723,25663,0.691557304158021
Mississippi,28051,3301,231,3070,0.8691959229898075
Mississippi,28053,2894,134,2760,0.9114927344782034
Mississippi,28055,175,20,155,0.7948717948717948
Mississippi,28057,377,151,226,0.42803030303030304
Mississippi,28059,4811,1448,3363,0.5373062789583001
Mississippi,28061,1976,203,1773,0.8136759981642956
Mississippi,28063,1550,175,1375,0.7971014492753623
Mississippi,28065,1806,190,1616,0.8096192384769539
Mississippi,28067,2681,510,2171,0.6803509871513632
Mississippi,28069,1008,106,902,0.8096947935368043
Mississippi,28071,2451,1336,1115,0.29442830736730924
Mississippi,28073,1464,544,920,0.4581673306772908
Mississippi,28075,3306,619,2687,0.6845859872611465
Mississippi,28077,1112,179,933,0.7226955848179706
Mississippi,28079,1614,260,1354,0.7225186766275347
Mississippi,28081,3020,884,2136,0.5471311475409836
Mississippi,28083,2094,219,1875,0.8106355382619974
Mississippi,28085,1817,309,1508,0.70931326434619
Mississippi,28087,4030,846,3184,0.6529942575881871
Mississippi,28089,7414,1434,5980,0.6758589511754068
Mississippi,28091,1539,202,1337,0.7679494543365881
Mississippi,28093,3361,386,2975,0.7939685081398452
Mississippi,28095,1913,311,1602,0.7203237410071942
Mississippi,28097,953,109,844,0.7947269303201506
Mississippi,28099,929,248,681,0.578589634664401
Mississippi,28101,1000,182,818,0.6920473773265652
Mississippi,28103,1397,134,1263,0.8249510124101894
Mississippi,28105,2389,739,1650,0.5274936061381074
Mississippi,28107,3061,479,2582,0.7293785310734463
Mississippi,28109,974,352,622,0.46907993966817496
Mississippi,28111,401,77,324,0.6778242677824268
Mississippi,28113,2870,425,2445,0.7420333839150227
Mississippi,28115,733,271,462,0.4601593625498008
Mississippi,28117,681,251,430,0.4613733905579399
Mississippi,28119,986,142,844,0.74822695035461
Mississippi,28121,4689,1356,3333,0.5513647642679901
Mississippi,28123,2013,309,1704,0.7338501291989664
Mississippi,28125,645,57,588,0.8376068376068376
Mississippi,28127,1855,294,1561,0.7263843648208469
Mississippi,28129,712,147,565,0.6577415599534342
Mississippi,28131,544,144,400,0.5813953488372093
Mississippi,28133,2332,299,2033,0.7727099961991638
Mississippi,28135,1341,166,1175,0.7796947577969475
Mississippi,28137,1435,242,1193,0.7113893858079905
Mississippi,28139,575,172,403,0.5394912985274432
Mississippi,28141,361,197,164,0.2939068100358423
Mississippi,28143,904,220,684,0.608540925266904
Mississippi,28145,593,223,370,0.4534313725490196
Mississippi,28147,1111,132,979,0.7876106194690266
Mississippi,28149,3463,612,2851,0.6996319018404908
Mississippi,28151,2982,409,2573,0.7587732232379829
Mississippi,28153,1441,251,1190,0.7033096926713948
Mississippi,28155,397,79,318,0.6680672268907563
Mississippi,28157,1269,69,1200,0.8968609865470852
Mississippi,28159,1442,202,1240,0.754257907542579
Mississippi,28161,1214,215,999,0.6990902729181245
Mississippi,28163,2203,203,2000,0.8312551953449709
Missouri,29001,799,1153,-354,-0.18135245901639344
Missouri,29003,498,728,-230,-0.18760195758564438
Missouri,29005,141,173,-32,-0.10191082802547771
Missouri,29007,749,728,21,0.014218009478672985
Missouri,29009,874,796,78,0.046706586826347304
Missouri,29011,205,214,-9,-0.021479713603818614
Missouri,29013,518,632,-114,-0.09913043478260869
Missouri,29015,669,567,102,0.0825242718446602
Missouri,29017,242,203,39,0.08764044943820225
Missouri,29019,9628,15076,-5448,-0.22053108808290156
Missouri,29021,3443,4148,-705,-0.09287313924384138
Missouri,29023,889,766,123,0.0743202416918429
Missouri,29025,244,314,-70,-0.12544802867383512
Missouri,29027,1378,1678,-300,-0.09816753926701571
Missouri,29029,1388,1419,-31,-0.0110438190238689
Missouri,29031,2076,2335,-259,-0.05871684425300385
Missouri,29033,233,255,-22,-0.045081967213114756
Missouri,29035,138,142,-4,-0.014285714285714285
Missouri,29037,3765,4185,-420,-0.052830188679245285
Missouri,29039,332,361,-29,-0.04184704184704185
Missouri,29041,321,274,47,0.07899159663865546
Missouri,29043,2146,3073,-927,-0.17762023376125693
Missouri,29045,202,178,24,0.06315789473684211
Missouri,29047,10630,12542,-1912,-0.08251337821508717
Missouri,29049,765,852,-87,-0.05380333951762523
Missouri,29051,2798,3303,-505,-0.08277331584986068
Missouri,29053,516,501,15,0.014749262536873156
Missouri,29055,522,712,-190,-0.1539708265802269
Missouri,29057,201,213,-12,-0.028985507246376812
Missouri,29059,397,515,-118,-0.12938596491228072
Missouri,29061,239,221,18,0.0391304347826087
Missouri,29063,221,328,-107,-0.19489981785063754
Missouri,29065,327,449,-122,-0.15721649484536082
Missouri,29067,268,384,-116,-0.17791411042944785
Missouri,29069,724,448,276,0.2354948805460751
Missouri,29071,3701,4784,-1083,-0.1276370064820271
Missouri,29073,401,507,-106,-0.11674008810572688
Missouri,29075,171,176,-5,-0.01440922190201729
Missouri,29077,10910,17403,-6493,-0.22932928336806413
Missouri,29079,219,262,-43,-0.0893970893970894
Missouri,29081,158,163,-5,-0.01557632398753894
Missouri,29083,780,696,84,0.056910569105691054
Missouri,29085,73,60,13,0.09774436090225563
Missouri,29087,128,110,18,0.07563025210084033
Missouri,29089,413,408,5,0.0060901339829476245
Missouri,29091,833,1209,-376,-0.1841332027424094
Missouri,29093,349,426,-77,-0.09935483870967741
Missouri,29095,48860,42823,6037,0.06584644917814644
Missouri,29097,2289,3826,-1537,-0.25134914145543746
Missouri,29099,9637,11830,-2193,-0.10215679880747193
Missouri,29101,1473,1944,-471,-0.13784021071115013
Missouri,29103,134,94,40,0.17543859649122806
Missouri,29105,737,927,-190,-0.1141826923076923
Missouri,29107,1173,1324,-151,-0.06047256708049659
Missouri,29109,872,1028,-156,-0.08210526315789474
Missouri,29111,239,239,0,0.0
Missouri,29113,1561,1976,-415,-0.1173310715295448
Missouri,29115,436,409,27,0.03195266272189349
Missouri,29117,397,398,-1,-0.0012578616352201257
Missouri,29119,364,385,-21,-0.028037383177570093
Missouri,29121,421,505,-84,-0.09071274298056156
Missouri,29123,346,334,12,0.01764705882352941
Missouri,29125,305,291,14,0.02348993288590604
Missouri,29127,925,707,218,0.13357843137254902
Missouri,29129,69,63,6,0.045454545454545456
Missouri,29131,432,480,-48,-0.05263157894736842
Missouri,29133,486,209,277,0.3985611510791367
Missouri,29135,340,409,-69,-0.09212283044058744
Missouri,29137,252,226,26,0.05439330543933055
Missouri,29139,330,324,6,0.009174311926605505
Missouri,29141,554,506,48,0.045283018867924525
Missouri,29143,691,360,331,0.3149381541389153
Missouri,29145,1240,1553,-313,-0.11206587898317222
Missouri,29147,616,831,-215,-0.14858327574291638
Missouri,29149,319,271,48,0.08135593220338982
Missouri,29151,314,326,-12,-0.01875
Missouri,29153,217,293,-76,-0.14901960784313725
Missouri,29155,602,250,352,0.4131455399061033
Missouri,29157,436,437,-1,-0.001145475372279496
Missouri,29159,1265,1509,-244,-0.08795962509012256
Missouri,29161,1137,1744,-607,-0.21069073238458869
Missouri,29163,661,475,186,0.1637323943661972
Missouri,29165,4645,5142,-497,-0.05078164912639215
Missouri,29167,744,851,-107,-0.0670846394984326
Missouri,29169,860,1020,-160,-0.0851063829787234
Missouri,29171,102,108,-6,-0.02857142857142857
Missouri,29173,415,311,104,0.14325068870523416
Missouri,29175,647,750,-103,-0.0737294201861131
Missouri,29177,942,968,-26,-0.013612565445026177
Missouri,29179,230,228,2,0.004366812227074236
Missouri,29181,259,250,9,0.01768172888015717
Missouri,29183,17805,21593,-3788,-0.09614701253870755
Missouri,29185,340,320,20,0.030303030303030304
Missouri,29186,842,798,44,0.026829268292682926
Missouri,29187,1939,2267,-328,-0.07798383262006657
Missouri,29189,89373,71134,18239,0.1136336732977378
Missouri,29195,910,805,105,0.061224489795918366
Missouri,29197,124,119,5,0.0205761316872428
Missouri,29199,108,134,-26,-0.10743801652892562
Missouri,29201,1067,834,233,0.12256706996317727
Missouri,29203,317,291,26,0.04276315789473684
Missouri,29205,240,200,40,0.09090909090909091
Missouri,29207,674,489,185,0.1590713671539123
Missouri,29209,806,885,-79,-0.04671791839148433
Missouri,29211,177,112,65,0.22491349480968859
Missouri,29213,1199,1373,-174,-0.06765163297045101
Missouri,29215,603,666,-63,-0.04964539007092199
Missouri,29217,490,518,-28,-0.027777777777777776
Missouri,29219,986,1222,-236,-0.1068840579710145
Missouri,29221,754,664,90,0.06346967559943582
Missouri,29223,393,264,129,0.1963470319634703
Missouri,29225,940,1170,-230,-0.10900473933649289
Missouri,29227,59,76,-17,-0.1259259259259259
Missouri,29229,402,385,17,0.021601016518424398
Missouri,29510,34458,27748,6710,0.10786740828858953
Montana,30001,241,318,-77,-0.13774597495527727
Montana,30003,512,595,-83,-0.07497741644083107
Montana,30005,280,396,-116,-0.17159763313609466
Montana,30007,188,256,-68,-0.15315315315315314
Montana,30009,614,684,-70,-0.053929121725731895
Montana,30011,21,26,-5,-0.10638297872340426
Montana,30013,4833,3681,1152,0.13530655391120508
Montana,30015,276,181,95,0.20787746170678337
Montana,30017,476,382,94,0.10955710955710955
Montana,30019,65,44,21,0.1926605504587156
Montana,30021,228,231,-3,-0.006535947712418301
Montana,30023,986,785,201,0.11349520045172219
Montana,30025,34,21,13,0.23636363636363636
Montana,30027,415,355,60,0.07792207792207792
Montana,30029,3021,3989,-968,-0.13808844507845935
Montana,30031,5951,8277,-2326,-0.1634804610626933
Montana,30033,9,17,-8,-0.3076923076923077
Montana,30035,928,1074,-146,-0.07292707292707293
Montana,30037,27,29,-2,-0.03571428571428571
Montana,30039,137,215,-78,-0.2215909090909091
Montana,30041,867,873,-6,-0.0034482758620689655
Montana,30043,716,787,-71,-0.047238855622089154
Montana,30045,69,69,0,0.0
Montana,30047,1338,1596,-258,-0.08793456032719836
Montana,30049,5362,5452,-90,-0.008322544849269465
Montana,30051,78,74,4,0.02631578947368421
Montana,30053,668,846,-178,-0.11756935270805813
Montana,30055,65,58,7,0.056910569105691054
Montana,30057,311,360,-49,-0.07302533532041729
Montana,30059,56,56,0,0.0
Montana,30061,173,213,-40,-0.10362694300518134
Montana,30063,8115,13271,-5156,-0.2410923033760404
Montana,30065,92,115,-23,-0.1111111111111111
Montana,30067,910,1480,-570,-0.2384937238493724
Montana,30069,16,16,0,0.0
Montana,30071,80,90,-10,-0.058823529411764705
Montana,30073,256,234,22,0.044897959183673466
Montana,30075,24,34,-10,-0.1724137931034483
Montana,30077,205,251,-46,-0.10087719298245613
Montana,30079,48,44,4,0.043478260869565216
Montana,30081,1855,2133,-278,-0.06970912738214644
Montana,30083,217,158,59,0.15733333333333333
Montana,30085,314,397,-83,-0.11673699015471167
Montana,30087,250,360,-110,-0.18032786885245902
Montana,30089,404,588,-184,-0.18548387096774194
Montana,30091,171,154,17,0.052307692307692305
Montana,30093,4089,3476,613,0.08103106411103768
Montana,30095,287,306,-19,-0.03204047217537943
Montana,30097,107,132,-25,-0.10460251046025104
Montana,30099,374,459,-85,-0.10204081632653061
Montana,30101,129,107,22,0.09322033898305085
Montana,30103,34,43,-9,-0.11688311688311688
Montana,30105,344,337,7,0.010279001468428781
Montana,30107,48,52,-4,-0.04
Montana,30109,36,16,20,0.38461538461538464
Montana,30111,7844,6975,869,0.058640933936163035
Nebraska,31001,177,284,-107,-0.23210412147505424
Nebraska,31003,27,23,4,0.08
Nebraska,31005,1,3,-2,-0.5
Nebraska,31007,4,3,1,0.14285714285714285
Nebraska,31009,4,5,-1,-0.1111111111111111
Nebraska,31011,27,17,10,0.22727272727272727
Nebraska,31013,45,75,-30,-0.25
Nebraska,31015,13,10,3,0.13043478260869565
Nebraska,31017,6,7,-1,-0.07692307692307693
Nebraska,31019,208,468,-260,-0.38461538461538464
Nebraska,31021,54,42,12,0.125
Nebraska,31023,25,28,-3,-0.05660377358490566
Nebraska,31025,132,151,-19,-0.06713780918727916
Nebraska,31027,20,23,-3,-0.06976744186046512
Nebraska,31029,16,10,6,0.23076923076923078
Nebraska,31031,20,11,9,0.2903225806451613
Nebraska,31033,28,44,-16,-0.2222222222222222
Nebraska,31035,12,35,-23,-0.48936170212765956
Nebraska,31037,24,16,8,0.2
Nebraska,31039,34,26,8,0.13333333333333333
Nebraska,31041,20,37,-17,-0.2982456140350877
Nebraska,31043,76,99,-23,-0.13142857142857142
Nebraska,31045,58,127,-69,-0.372972972972973
Nebraska,31047,39,86,-47,-0.376
Nebraska,31049,2,3,-1,-0.2
Nebraska,31051,28,33,-5,-0.08196721311475409
Nebraska,31053,205,185,20,0.05128205128205128
Nebraska,31055,5387,6322,-935,-0.07985310444956871
Nebraska,31057,14,1,13,0.8666666666666667
Nebraska,31059,34,34,0,0.0
Nebraska,31061,11,9,2,0.1
Nebraska,31063,9,5,4,0.2857142857142857
Nebraska,31065,12,13,-1,-0.04
Nebraska,31067,175,147,28,0.08695652173913043
Nebraska,31069,8,13,-5,-0.23809523809523808
Nebraska,31071,0,0,0,0
Nebraska,31073,12,17,-5,-0.1724137931034483
Nebraska,31075,0,0,0,0
Nebraska,31077,11,9,2,0.1
Nebraska,31079,299,370,-71,-0.10612855007473841
Nebraska,31081,23,44,-21,-0.31343283582089554
Nebraska,31083,13,12,1,0.04
Nebraska,31085,9,0,9,1.0
Nebraska,31087,6,4,2,0.2
Nebraska,31089,30,24,6,0.1111111111111111
Nebraska,31091,3,4,-1,-0.14285714285714285
Nebraska,31093,43,30,13,0.1780821917808219
Nebraska,31095,41,58,-17,-0.1717171717171717
Nebraska,31097,24,29,-5,-0.09433962264150944
Nebraska,31099,34,36,-2,-0.02857142857142857
Nebraska,31101,40,37,3,0.03896103896103896
Nebraska,31103,4,5,-1,-0.1111111111111111
Nebraska,31105,8,15,-7,-0.30434782608695654
Nebraska,31107,25,16,9,0.21951219512195122
Nebraska,31109,4016,6456,-2440,-0.23300229182582124
Nebraska,31111,182,201,-19,-0.04960835509138381
Nebraska,31113,2,1,1,0.3333333333333333
Nebraska,31115,5,6,-1,-0.09090909090909091
Nebraska,31117,3,1,2,0.5
Nebraska,31119,129,200,-71,-0.21580547112462006
Nebraska,31121,35,25,10,0.16666666666666666
Nebraska,31123,13,18,-5,-0.16129032258064516
Nebraska,31125,14,11,3,0.12
Nebraska,31127,35,39,-4,-0.05405405405405406
Nebraska,31129,17,18,-1,-0.02857142857142857
Nebraska,31131,76,104,-28,-0.15555555555555556
Nebraska,31133,29,11,18,0.45
Nebraska,31135,16,5,11,0.5238095238095238
Nebraska,31137,33,42,-9,-0.12
Nebraska,31139,10,20,-10,-0.3333333333333333
Nebraska,31141,128,108,20,0.0847457627118644
Nebraska,31143,31,27,4,0.06896551724137931
Nebraska,31145,25,46,-21,-0.29577464788732394
Nebraska,31147,36,28,8,0.125
Nebraska,31149,3,7,-4,-0.4
Nebraska,31151,109,89,20,0.10101010101010101
Nebraska,31153,1099,1620,-521,-0.19161456417800662
Nebraska,31155,104,181,-77,-0.27017543859649124
Nebraska,31157,123,206,-83,-0.25227963525835867
Nebraska,31159,86,121,-35,-0.16908212560386474
Nebraska,31161,10,16,-6,-0.23076923076923078
Nebraska,31163,11,21,-10,-0.3125
Nebraska,31165,12,9,3,0.14285714285714285
Nebraska,31167,19,35,-16,-0.2962962962962963
Nebraska,31169,40,18,22,0.3793103448275862
Nebraska,31171,1,0,1,1.0
Nebraska,31173,24,27,-3,-0.058823529411764705
Nebraska,31175,35,22,13,0.22807017543859648
Nebraska,31177,136,140,-4,-0.014492753623188406
Nebraska,31179,58,52,6,0.05454545454545454
Nebraska,31181,16,8,8,0.3333333333333333
Nebraska,31183,3,3,0,0.0
Nebraska,31185,36,73,-37,-0.3394495412844037
Nevada,32001,46,46,0,0.0
Nevada,32003,4767,3920,847,0.09750201450443191
Nevada,32005,85,72,13,0.08280254777070063
Nevada,32007,38,48,-10,-0.11627906976744186
Nevada,32009,7,15,-8,-0.36363636363636365
Nevada,32011,3,19,-16,-0.7272727272727273
Nevada,32013,27,53,-26,-0.325
Nevada,32015,20,48,-28,-0.4117647058823529
Nevada,32017,38,25,13,0.20634920634920634
Nevada,32019,80,88,-8,-0.047619047619047616
Nevada,32021,39,34,5,0.0684931506849315
Nevada,32023,94,65,29,0.18238993710691823
Nevada,32027,32,33,-1,-0.015384615384615385
Nevada,32029,35,38,-3,-0.0410958904109589
Nevada,32031,868,1023,-155,-0.08196721311475409
Nevada,32033,47,46,1,0.010752688172043012
Nevada,32510,79,83,-4,-0.024691358024691357
New Hampshire,33001,3490,5990,-2500,-0.26371308016877637
New Hampshire,33003,3230,5655,-2425,-0.27293190770962295
New Hampshire,33005,5166,12471,-7305,-0.4141860860690594
New Hampshire,33007,2013,3637,-1624,-0.28743362831858404
New Hampshire,33009,6918,14258,-7340,-0.3466188137514167
New Hampshire,33011,28099,38646,-10547,-0.15801932729043375
New Hampshire,33013,12209,18076,-5867,-0.19372626712894173
New Hampshire,33015,22829,31080,-8251,-0.15305422100205904
New Hampshire,33017,8801,15865,-7064,-0.2863861185437444
New Hampshire,33019,2497,5906,-3409,-0.4056884446031179
New Jersey,34001,11018,6801,4217,0.23665750042089903
New Jersey,34003,55264,34137,21127,0.2363172671446628
New Jersey,34005,32712,20087,12625,0.2391143771662342
New Jersey,34007,43720,26383,17337,0.24730753320114687
New Jersey,34009,3964,3249,715,0.09912657701372522
New Jersey,34011,6875,3829,3046,0.28456651718983555
New Jersey,34013,75071,27449,47622,0.46451424112368317
New Jersey,34015,17954,14011,3943,0.12335366807445644
New Jersey,34017,49798,25112,24686,0.32954211720731547
New Jersey,34019,5373,5047,326,0.03128598848368522
New Jersey,34021,29505,15098,14407,0.32300517902383247
New Jersey,34023,47978,30498,17480,0.2227432590855803
New Jersey,34025,30835,22185,8650,0.16314598264805732
New Jersey,34027,24226,17259,6967,0.1679402193563939
New Jersey,34029,19572,16305,3267,0.09106112551216657
New Jersey,34031,29538,14116,15422,0.3532780501214093
New Jersey,34033,2814,2163,651,0.1308016877637131
New Jersey,34035,19667,12235,7432,0.23296345056736253
New Jersey,34037,3982,5283,-1301,-0.14042093901780897
New Jersey,34039,40972,18491,22481,0.37806703328120006
New Jersey,34041,3399,3521,-122,-0.01763005780346821
New Mexico,35001,36937,38247,-1310,-0.0174239199829751
New Mexico,35003,115,183,-68,-0.22818791946308725
New Mexico,35005,1238,950,288,0.1316270566727605
New Mexico,35006,1586,1494,92,0.02987012987012987
New Mexico,35007,949,740,209,0.12374185908821789
New Mexico,35009,672,768,-96,-0.06666666666666667
New Mexico,35011,96,114,-18,-0.08571428571428572
New Mexico,35013,9097,7243,1854,0.1134638922888617
New Mexico,35015,1566,1340,226,0.07777013076393668
New Mexico,35017,2272,2267,5,0.0011015642211940956
New Mexico,35019,399,330,69,0.09465020576131687
New Mexico,35021,75,46,29,0.2396694214876033
New Mexico,35023,515,323,192,0.22911694510739858
New Mexico,35025,705,651,54,0.03982300884955752
New Mexico,35027,515,527,-12,-0.011516314779270634
New Mexico,35028,1424,1404,20,0.007072135785007072
New Mexico,35029,917,714,203,0.12446351931330472
New Mexico,35031,4761,3299,1462,0.18138957816377171
New Mexico,35033,986,603,383,0.24103209565764633
New Mexico,35035,1324,1190,134,0.053301511535401754
New Mexico,35037,473,445,28,0.030501089324618737
New Mexico,35039,4915,3252,1663,0.2036243418635974
New Mexico,35041,281,392,-111,-0.1649331352154532
New Mexico,35043,7448,6958,490,0.034013605442176874
New Mexico,35045,3019,2735,284,0.049356969064998264
New Mexico,35047,3418,2341,1077,0.1870116339642299
New Mexico,35049,16087,15703,384,0.0120792702107581
New Mexico,35051,400,530,-130,-0.13978494623655913
New Mexico,35053,1050,1024,26,0.01253616200578592
New Mexico,35055,3285,4325,-1040,-0.1366622864651774
New Mexico,35057,649,651,-2,-0.0015384615384615385
New Mexico,35059,154,190,-36,-0.10465116279069768
New Mexico,35061,3123,2877,246,0.041
New York,36001,18450,20422,-1972,-0.050730603004733484
New York,36003,762,1119,-357,-0.189792663476874
New York,36005,95772,41114,54658,0.39929576435866343
New York,36007,7035,9176,-2141,-0.1320708161125162
New York,36009,1718,2367,-649,-0.15887392900856792
New York,36011,2383,2654,-271,-0.053801866190192574
New York,36013,3483,4081,-598,-0.07905869910100476
New York,36015,2520,2564,-44,-0.00865460267505901
New York,36017,958,1494,-536,-0.21859706362153344
New York,36019,1550,4301,-2751,-0.470176038284054
New York,36021,2481,3302,-821,-0.14196783676292582
New York,36023,1402,1878,-476,-0.14512195121951219
New York,36025,1067,1663,-596,-0.21831501831501832
New York,36027,11005,11680,-675,-0.02975534494159136
New York,36029,50199,49387,812,0.008153756552125802
New York,36031,708,1932,-1224,-0.4636363636363636
New York,36033,961,2338,-1377,-0.4173992118823886
New York,36035,881,1385,-504,-0.22241835834068843
New York,36037,1262,1539,-277,-0.09889325240985362
New York,36039,1062,1458,-396,-0.15714285714285714
New York,36041,123,210,-87,-0.26126126126126126
New York,36043,1377,1755,-378,-0.1206896551724138
New York,36045,2379,2466,-87,-0.017956656346749224
New York,36047,174236,116327,57909,0.19929929137570854
New York,36049,449,648,-199,-0.1814038286235187
New York,36051,1611,2410,-799,-0.19870678935588162
New York,36053,1880,2346,-466,-0.110269758637009
New York,36055,37309,34717,2592,0.03598700469274984
New York,36057,1185,1630,-445,-0.15808170515097691
New York,36059,70947,42301,28646,0.25294927945747386
New York,36061,177496,90227,87269,0.32596751119627376
New York,36063,7694,8916,-1222,-0.07357013847080072
New York,36065,6054,7272,-1218,-0.09140027014858172
New York,36067,20397,18057,2340,0.060851926977687626
New York,36069,2884,3361,-477,-0.07638110488390712
New York,36071,12239,11536,703,0.02956887486855941
New York,36073,650,877,-227,-0.14865749836280287
New York,36075,2424,3066,-642,-0.11693989071038251
New York,36077,1817,2623,-806,-0.18153153153153154
New York,36079,3477,3573,-96,-0.013617021276595745
New York,36081,122386,76305,46081,0.23192293561359095
New York,36083,4738,6649,-1911,-0.16782295600245895
New York,36085,16127,14340,1787,0.058653625233859585
New York,36087,16966,11072,5894,0.21021470860974392
New York,36089,2865,4102,-1237,-0.17755131333429022
New York,36091,7206,9112,-1906,-0.11680352984434367
New York,36093,6146,6862,-716,-0.0550430504305043
New York,36095,622,1088,-466,-0.27251461988304093
New York,36097,491,818,-327,-0.24980901451489687
New York,36099,1042,1164,-122,-0.05530371713508613
New York,36101,1970,2709,-739,-0.15793973071169054
New York,36103,49926,41363,8563,0.0938010055976076
New York,36105,2088,2671,-583,-0.12250472788400925
New York,36107,1232,1825,-593,-0.19398102715080143
New York,36109,5625,9298,-3673,-0.24613013469141592
New York,36111,6927,11572,-4645,-0.2510946537650684
New York,36113,1639,2637,-998,-0.2333956969130028
New York,36115,1167,2087,-920,-0.28272894898586354
New York,36117,1859,2319,-460,-0.11010052656773577
New York,36119,69628,33726,35902,0.3473692358302533
New York,36121,594,909,-315,-0.20958083832335328
New York,36123,552,669,-117,-0.09582309582309582
North Carolina,37001,7374,5755,1619,0.12331479929926117
North Carolina,37003,1148,1123,25,0.011008366358432409
North Carolina,37005,563,571,-8,-0.007054673721340388
North Carolina,37007,2307,914,1393,0.4324743868363862
North Carolina,37009,1219,1205,14,0.005775577557755775
North Carolina,37011,326,425,-99,-0.1318242343541944
North Carolina,37013,2934,1840,1094,0.22915793883535818
North Carolina,37015,2065,756,1309,0.4640198511166253
North Carolina,37017,3442,1524,1918,0.38622633910592025
North Carolina,37019,7192,4252,2940,0.25690318070604684
North Carolina,37021,17604,30913,-13309,-0.2743162190572377
North Carolina,37023,3511,3460,51,0.007316023526036436
North Carolina,37025,8096,6931,1165,0.07752711785452851
North Carolina,37027,2156,2108,48,0.01125703564727955
North Carolina,37029,468,298,170,0.22193211488250653
North Carolina,37031,2946,2694,252,0.04468085106382979
North Carolina,37033,1701,885,816,0.31554524361948955
North Carolina,37035,5310,4561,749,0.07587883699726472
North Carolina,37037,7406,5510,1896,0.14679467327345927
North Carolina,37039,1024,1021,3,0.001466992665036675
North Carolina,37041,974,470,504,0.3490304709141274
North Carolina,37043,487,355,132,0.15676959619952494
North Carolina,37045,4880,3104,1776,0.22244488977955912
North Carolina,37047,3628,2002,1626,0.288809946714032
North Carolina,37049,5187,3184,2003,0.23927846135467687
North Carolina,37051,22744,11052,11692,0.34595810155047935
North Carolina,37053,780,710,70,0.04697986577181208
North Carolina,37055,2003,2307,-304,-0.07053364269141531
North Carolina,37057,4489,3878,611,0.07302497908449862
North Carolina,37059,1377,1031,346,0.143687707641196
North Carolina,37061,3036,1450,1586,0.3535443602318324
North Carolina,37063,35845,25584,10261,0.16703836949974768
North Carolina,37065,6411,2058,4353,0.5139922068721219
North Carolina,37067,24446,16779,7667,0.18597938144329898
North Carolina,37069,4951,2858,2093,0.2680240747855039
North Carolina,37071,7697,5738,1959,0.14581317454410123
North Carolina,37073,749,356,393,0.3556561085972851
North Carolina,37075,321,295,26,0.04220779220779221
North Carolina,37077,4693,2715,1978,0.26700863930885527
North Carolina,37079,1643,822,821,0.3330628803245436
North Carolina,37081,37880,28204,9676,0.14641970825010592
North Carolina,37083,6224,2313,3911,0.45812346257467496
North Carolina,37085,4655,3111,1544,0.19881534895699202
North Carolina,37087,3748,3873,-125,-0.016402046975462537
North Carolina,37089,4811,5129,-318,-0.03199195171026157
North Carolina,37091,2926,961,1965,0.5055312580396193
North Carolina,37093,3528,1837,1691,0.3151910531220876
North Carolina,37095,459,388,71,0.08382526564344746
North Carolina,37097,5888,4998,890,0.08175638434686754
North Carolina,37099,2022,3021,-999,-0.1980963712076145
North Carolina,37101,7992,6223,1769,0.12444600773830461
North Carolina,37103,910,501,409,0.2898653437278526
North Carolina,37105,3224,2248,976,0.1783625730994152
North Carolina,37107,4731,1947,2784,0.4168912848158131
North Carolina,37109,2812,2291,521,0.1020968058005095
North Carolina,37111,1353,1622,-269,-0.09042016806722689
North Carolina,37113,1548,1428,120,0.04032258064516129
North Carolina,37115,1201,2044,-843,-0.25978428351309707
North Carolina,37117,2469,1097,1372,0.3847448121144139
North Carolina,37119,71265,45224,26041,0.22354900462704633
North Carolina,37121,314,450,-136,-0.17801047120418848
North Carolina,37123,1366,885,481,0.2136828076410484
North Carolina,37125,4679,2948,1731,0.22695686377343646
North Carolina,37127,8554,3664,4890,0.40022917007693565
North Carolina,37129,12240,12276,-36,-0.0014684287812041115
North Carolina,37131,3195,1067,2128,0.4992961051149695
North Carolina,37133,4560,3213,1347,0.1732921651871864
North Carolina,37135,17546,18096,-550,-0.015431232815218002
North Carolina,37137,922,676,246,0.1539424280350438
North Carolina,37139,2471,1128,1343,0.3731592108919144
North Carolina,37141,2880,1880,1000,0.21008403361344538
North Carolina,37143,711,481,230,0.1929530201342282
North Carolina,37145,2954,2150,804,0.15752351097178682
North Carolina,37147,11856,7548,4308,0.2220160791589363
North Carolina,37149,1099,1123,-24,-0.010801080108010801
North Carolina,37151,2969,2914,55,0.009348971613122557
North Carolina,37153,2941,1595,1346,0.2967372134038801
North Carolina,37155,8457,5206,3251,0.23794188684769085
North Carolina,37157,4464,3000,1464,0.19614147909967847
North Carolina,37159,5031,3969,1062,0.118
North Carolina,37161,2382,2306,76,0.016211604095563138
North Carolina,37163,3790,1554,2236,0.4184131736526946
North Carolina,37165,2671,1142,1529,0.4009965906110674
North Carolina,37167,2153,1813,340,0.08572869389813415
North Carolina,37169,1433,1319,114,0.04142441860465116
North Carolina,37171,2380,2204,176,0.038394415357766144
North Carolina,37173,666,831,-165,-0.11022044088176353
North Carolina,37175,1794,1954,-160,-0.042689434364994665
North Carolina,37177,266,197,69,0.1490280777537797
North Carolina,37179,7630,5547,2083,0.15807847006147074
North Carolina,37181,4561,1999,2562,0.3905487804878049
North Carolina,37183,77927,65380,12547,0.08755329467506821
North Carolina,37185,2827,988,1839,0.4820445609436435
North Carolina,37187,1374,597,777,0.3942161339421613
North Carolina,37189,2514,5811,-3297,-0.39603603603603604
North Carolina,37191,7546,3564,3982,0.3584158415841584
North Carolina,37193,2107,1783,324,0.0832904884318766
North Carolina,37195,6408,2935,3473,0.3717221449213315
North Carolina,37197,832,783,49,0.030340557275541795
North Carolina,37199,1134,1386,-252,-0.1
North Dakota,38000,101,253,-152,-0.429378531
Ohio,39001,877,638,239,0.15775577557755777
Ohio,39003,3670,2730,940,0.146875
Ohio,39005,1451,1465,-14,-0.004801097393689987
Ohio,39007,5320,4256,1064,0.1111111111111111
Ohio,39009,3533,5663,-2130,-0.23162244454110484
Ohio,39011,1031,952,79,0.03983862834089763
Ohio,39013,3982,3263,719,0.09924085576259489
Ohio,39015,1562,1067,495,0.18828451882845187
Ohio,39017,12874,11102,1772,0.07390724057390724
Ohio,39019,1084,976,108,0.05242718446601942
Ohio,39021,1226,1099,127,0.0546236559139785
Ohio,39023,7107,4905,2202,0.18331668331668333
Ohio,39025,5642,5710,-68,-0.005990133897110641
Ohio,39027,909,942,-33,-0.017828200972447326
Ohio,39029,4106,3573,533,0.06941007943742675
Ohio,39031,1358,1128,230,0.0925181013676589
Ohio,39033,1344,1141,203,0.08169014084507042
Ohio,39035,125914,72297,53617,0.27050466422146097
Ohio,39037,1246,999,247,0.11002227171492204
Ohio,39039,1507,1435,72,0.024473147518694765
Ohio,39041,9552,6891,2661,0.1618317825214377
Ohio,39043,5449,4299,1150,0.11797291752154287
Ohio,39045,6408,5074,1334,0.11618184985194217
Ohio,39047,760,533,227,0.17556071152358854
Ohio,39049,84654,67855,16799,0.11015087634172409
Ohio,39051,1480,1528,-48,-0.015957446808510637
Ohio,39053,945,966,-21,-0.01098901098901099
Ohio,39055,4171,3516,655,0.08520879406790685
Ohio,39057,6672,6759,-87,-0.006477551932097387
Ohio,39059,1440,1228,212,0.07946026986506746
Ohio,39061,57687,38956,18731,0.19381641712281283
Ohio,39063,2062,2490,-428,-0.09402460456942004
Ohio,39065,771,669,102,0.07083333333333333
Ohio,39067,818,674,144,0.09651474530831099
Ohio,39069,977,952,25,0.012960082944530845
Ohio,39071,1119,873,246,0.12349397590361445
Ohio,39073,1204,1060,144,0.0636042402826855
Ohio,39075,561,558,3,0.002680965147453083
Ohio,39077,2036,1907,129,0.03271620593456759
Ohio,39079,1010,694,316,0.18544600938967137
Ohio,39081,4328,3353,975,0.12693659679729202
Ohio,39083,1902,1987,-85,-0.021856518385188994
Ohio,39085,12506,10351,2155,0.09428183926149539
Ohio,39087,2654,1994,660,0.14199655765920827
Ohio,39089,6785,5849,936,0.07408580022162418
Ohio,39091,1012,998,14,0.006965174129353234
Ohio,39093,21144,16154,4990,0.13378733444152502
Ohio,39095,32137,24111,8026,0.14268951784952355
Ohio,39097,1225,923,302,0.14059590316573556
Ohio,39099,21000,14066,6934,0.1977414019277933
Ohio,39101,2585,1909,676,0.15042278593680464
Ohio,39103,7913,6888,1025,0.06925207756232687
Ohio,39105,800,757,43,0.027617212588310854
Ohio,39107,1037,860,177,0.09330521876647338
Ohio,39109,3155,2706,449,0.0766080873571063
Ohio,39111,1191,1138,53,0.022756547874624302
Ohio,39113,33352,22538,10814,0.19348720701377706
Ohio,39115,566,430,136,0.13654618473895583
Ohio,39117,1164,1035,129,0.058663028649386086
Ohio,39119,3066,2299,767,0.1429636533084809
Ohio,39121,522,404,118,0.12742980561555076
Ohio,39123,2566,2012,554,0.12101354303189166
Ohio,39125,723,540,183,0.14489311163895488
Ohio,39127,1465,1070,395,0.15581854043392504
Ohio,39129,2097,1631,466,0.125
Ohio,39131,1336,949,387,0.16936542669584245
Ohio,39133,8665,8877,-212,-0.012085281039790218
Ohio,39135,1176,1046,130,0.05850585058505851
Ohio,39137,811,936,-125,-0.07155123068116771
Ohio,39139,5225,4080,1145,0.123052122514777
Ohio,39141,3582,2595,987,0.15978630403108304
Ohio,39143,2866,2456,410,0.07703870725291244
Ohio,39145,3499,2903,596,0.09309590752889722
Ohio,39147,2081,2064,17,0.004101326899879373
Ohio,39149,1284,1110,174,0.07268170426065163
Ohio,39151,21515,16235,5280,0.13986754966887419
Ohio,39153,38874,29451,9423,0.13791437980241492
Ohio,39155,17903,14726,3177,0.09736737258267186
Ohio,39157,4479,4019,460,0.05413038361967522
Ohio,39159,1580,1501,79,0.02564102564102564
Ohio,39161,710,621,89,0.06686701728024042
Ohio,39163,515,496,19,0.018793273986152326
Ohio,39165,6970,6054,916,0.07033169533169534
Ohio,39167,2557,2411,146,0.02938808373590982
Ohio,39169,3448,3225,223,0.03341825265997302
Ohio,39171,1007,1156,-149,-0.06888580674988443
Ohio,39173,6108,7165,-1057,-0.0796353499585625
Ohio,39175,661,647,14,0.010703363914373088
Oklahoma,40001,582,971,-389,-0.2504829362524147
Oklahoma,40003,92,191,-99,-0.3498233215547703
Oklahoma,40005,370,723,-353,-0.322964318389753
Oklahoma,40007,52,94,-42,-0.2876712328767123
Oklahoma,40009,464,824,-360,-0.2795031055900621
Oklahoma,40011,313,435,-122,-0.16310160427807488
Oklahoma,40013,1050,1913,-863,-0.2912588592642592
Oklahoma,40015,1060,1543,-483,-0.18555512869765656
Oklahoma,40017,3357,4922,-1565,-0.1890324918468414
Oklahoma,40019,1240,2113,-873,-0.2603638532657322
Oklahoma,40021,2023,2897,-874,-0.17764227642276423
Oklahoma,40023,384,745,-361,-0.31975199291408324
Oklahoma,40025,22,68,-46,-0.5111111111111111
Oklahoma,40027,10433,16428,-5995,-0.2231860317933063
Oklahoma,40029,136,456,-320,-0.5405405405405406
Oklahoma,40031,3523,3804,-281,-0.03835130339838952
Oklahoma,40033,204,388,-184,-0.3108108108108108
Oklahoma,40035,609,926,-317,-0.206514657980456
Oklahoma,40037,2301,2786,-485,-0.09534106546097897
Oklahoma,40039,750,1273,-523,-0.25852694018783984
Oklahoma,40041,1447,1773,-326,-0.10124223602484472
Oklahoma,40043,134,270,-136,-0.33663366336633666
Oklahoma,40045,70,193,-123,-0.467680608365019
Oklahoma,40047,1403,1771,-368,-0.11594202898550725
Oklahoma,40049,909,1505,-596,-0.24689312344656172
Oklahoma,40051,1629,2677,-1048,-0.24338132837900603
Oklahoma,40053,125,224,-99,-0.2836676217765043
Oklahoma,40055,164,332,-168,-0.3387096774193548
Oklahoma,40057,122,167,-45,-0.15570934256055363
Oklahoma,40059,68,151,-83,-0.3789954337899543
Oklahoma,40061,475,752,-277,-0.22575387123064386
Oklahoma,40063,537,873,-336,-0.23829787234042554
Oklahoma,40065,505,652,-147,-0.12705272255834055
Oklahoma,40067,197,347,-150,-0.2757352941176471
Oklahoma,40069,260,606,-346,-0.3995381062355658
Oklahoma,40071,1288,1791,-503,-0.16336472880805455
Oklahoma,40073,268,472,-204,-0.2756756756756757
Oklahoma,40075,331,514,-183,-0.2165680473372781
Oklahoma,40077,499,852,-353,-0.2612879348630644
Oklahoma,40079,1498,2283,-785,-0.20761703253107644
Oklahoma,40081,1161,1623,-462,-0.16594827586206898
Oklahoma,40083,1314,1645,-331,-0.1118621155795877
Oklahoma,40085,314,502,-188,-0.23039215686274508
Oklahoma,40087,1157,1865,-708,-0.2342819324950364
Oklahoma,40089,712,1314,-602,-0.29713721618953604
Oklahoma,40091,1022,1261,-239,-0.10468681559351731
Oklahoma,40093,140,215,-75,-0.2112676056338028
Oklahoma,40095,400,738,-338,-0.29701230228471004
Oklahoma,40097,1659,2144,-485,-0.12753089666053116
Oklahoma,40099,544,909,-365,-0.25120440467997246
Oklahoma,40101,3381,3515,-134,-0.01943155452436195
Oklahoma,40103,362,562,-200,-0.21645021645021645
Oklahoma,40105,406,530,-124,-0.13247863247863248
Oklahoma,40107,421,596,-175,-0.1720747295968535
Oklahoma,40109,34255,32368,1887,0.028323551926511866
Oklahoma,40111,1867,1882,-15,-0.0040010669511869835
Oklahoma,40113,2390,2327,63,0.013355946576213695
Oklahoma,40115,972,1238,-266,-0.12036199095022625
Oklahoma,40117,603,762,-159,-0.11648351648351649
Oklahoma,40119,2622,3829,-1207,-0.18710277476360254
Oklahoma,40121,1717,3026,-1309,-0.27598566308243727
Oklahoma,40123,1186,2392,-1206,-0.3370598099496926
Oklahoma,40125,2300,3400,-1100,-0.19298245614035087
Oklahoma,40127,317,667,-350,-0.3556910569105691
Oklahoma,40129,100,268,-168,-0.45652173913043476
Oklahoma,40131,2810,3757,-947,-0.1442058778742196
Oklahoma,40133,932,1194,-262,-0.12323612417685795
Oklahoma,40135,1359,1872,-513,-0.15877437325905291
Oklahoma,40137,1174,2108,-934,-0.2845825716026813
Oklahoma,40139,267,393,-126,-0.19090909090909092
Oklahoma,40141,214,346,-132,-0.2357142857142857
Oklahoma,40143,25372,26525,-1153,-0.022217083839142917
Oklahoma,40145,2493,2813,-320,-0.0603090840557859
Oklahoma,40147,1649,2006,-357,-0.09767441860465116
Oklahoma,40149,292,700,-408,-0.4112903225806452
Oklahoma,40151,217,363,-146,-0.2517241379310345
Oklahoma,40153,343,694,-351,-0.33847637415621984
Oregon,41001,493,743,-250,-0.2022653721682848
Oregon,41003,7348,11567,-4219,-0.22305048902987049
Oregon,41005,26378,27969,-1591,-0.02927484497764366
Oregon,41007,2628,3334,-706,-0.11841663871184166
Oregon,41009,3045,4221,-1176,-0.16184971098265896
Oregon,41011,3472,4428,-956,-0.1210126582278481
Oregon,41013,840,1019,-179,-0.09628832705755783
Oregon,41015,1424,1567,-143,-0.04781009695753929
Oregon,41017,10812,12325,-1513,-0.0653930933137399
Oregon,41019,4499,5691,-1192,-0.1169774288518155
Oregon,41021,101,100,1,0.004975124378109453
Oregon,41023,213,381,-168,-0.2828282828282828
Oregon,41025,236,352,-116,-0.19727891156462585
Oregon,41027,1633,2527,-894,-0.21490384615384617
Oregon,41029,12483,16112,-3629,-0.12691029900332226
Oregon,41031,799,867,-68,-0.04081632653061224
Oregon,41033,3988,5229,-1241,-0.13464250840837583
Oregon,41035,2275,2826,-551,-0.10801803567927858
Oregon,41037,199,293,-94,-0.1910569105691057
Oregon,41039,26772,41883,-15111,-0.2201005025125628
Oregon,41041,4027,4674,-647,-0.07435926904953453
Oregon,41043,4943,6865,-1922,-0.1627710027100271
Oregon,41045,566,612,-46,-0.03904923599320883
Oregon,41047,13920,15677,-1757,-0.059364124742372536
Oregon,41049,292,332,-40,-0.0641025641025641
Oregon,41051,65735,87247,-21512,-0.1406178504660679
Oregon,41053,4440,5323,-883,-0.09044351121581481
Oregon,41055,67,81,-14,-0.0945945945945946
Oregon,41057,1899,2207,-308,-0.07501217730150998
Oregon,41059,2003,2289,-286,-0.06663560111835974
Oregon,41061,929,1342,-413,-0.18185821224130339
Oregon,41063,331,495,-164,-0.19854721549636803
Oregon,41065,1259,1795,-536,-0.17550753110674525
Oregon,41067,36321,41841,-5520,-0.07062255315882399
Oregon,41069,48,86,-38,-0.2835820895522388
Oregon,41071,5321,6446,-1125,-0.09560635676043172
Pennsylvania,42001,3846,4066,-220,-0.027805864509605663
Pennsylvania,42003,122399,98012,24387,0.11064329820199537
Pennsylvania,42005,2924,3015,-91,-0.01532244485603637
Pennsylvania,42007,12963,9563,3400,0.1509366953742342
Pennsylvania,42009,1387,1382,5,0.0018057060310581437
Pennsylvania,42011,20470,21518,-1048,-0.024959512241592836
Pennsylvania,42013,3816,4245,-429,-0.05321920357275772
Pennsylvania,42015,1761,1792,-31,-0.008725021108922038
Pennsylvania,42017,46876,36111,10765,0.129719112632099
Pennsylvania,42019,8529,7606,923,0.0572048342113418
Pennsylvania,42021,8304,8841,-537,-0.03132108486439195
Pennsylvania,42023,176,228,-52,-0.12871287128712872
Pennsylvania,42025,3334,3418,-84,-0.012440758293838863
Pennsylvania,42027,8431,10269,-1838,-0.09828877005347593
Pennsylvania,42029,32985,26046,6939,0.1175484067693246
Pennsylvania,42031,1528,1510,18,0.005924950625411455
Pennsylvania,42033,3084,3318,-234,-0.03655107778819119
Pennsylvania,42035,1647,1690,-43,-0.012885825591848966
Pennsylvania,42037,2382,3455,-1073,-0.1838273085489121
Pennsylvania,42039,3559,3683,-124,-0.01712234189450428
Pennsylvania,42041,11997,11167,830,0.035831462614401656
Pennsylvania,42043,18397,13709,4688,0.14601632093689654
Pennsylvania,42045,44775,29841,14934,0.20014474107430041
Pennsylvania,42047,1528,1791,-263,-0.07924073516119313
Pennsylvania,42049,19511,17830,1681,0.04501754104067915
Pennsylvania,42051,9184,6451,2733,0.1748001279181324
Pennsylvania,42053,251,221,30,0.0635593220338983
Pennsylvania,42055,4700,4273,427,0.047587206062632344
Pennsylvania,42057,366,364,2,0.0027397260273972603
Pennsylvania,42059,2166,1872,294,0.07280832095096583
Pennsylvania,42061,1302,1664,-362,-0.12204989885367498
Pennsylvania,42063,3915,3654,261,0.034482758620689655
Pennsylvania,42065,1204,1486,-282,-0.10483271375464684
Pennsylvania,42067,638,741,-103,-0.07469180565627266
Pennsylvania,42069,22971,17265,5706,0.14181330152102595
Pennsylvania,42071,19780,21202,-1422,-0.03469816016787858
Pennsylvania,42073,5842,3972,1870,0.190544120643978
Pennsylvania,42075,4529,4482,47,0.005215847297747198
Pennsylvania,42077,19767,17742,2025,0.05398704310965368
Pennsylvania,42079,20530,18524,2006,0.051364776975469865
Pennsylvania,42081,3803,4717,-914,-0.10727699530516432
Pennsylvania,42083,1013,1167,-154,-0.07064220183486239
Pennsylvania,42085,6323,4615,1708,0.15615286158347047
Pennsylvania,42087,1201,1242,-41,-0.016782644289807615
Pennsylvania,42089,7901,6795,1106,0.07525857376156778
Pennsylvania,42091,75333,51913,23420,0.18405293683102023
Pennsylvania,42093,845,887,-42,-0.02424942263279446
Pennsylvania,42095,17804,16624,1180,0.034274427791332635
Pennsylvania,42097,3436,3547,-111,-0.01589574681369039
Pennsylvania,42099,1326,1751,-425,-0.13812154696132597
Pennsylvania,42101,212785,125688,87097,0.25732333155081794
Pennsylvania,42103,2006,1884,122,0.031362467866323906
Pennsylvania,42105,402,557,-155,-0.1616266944734098
Pennsylvania,42107,6533,6040,493,0.03921100771494472
Pennsylvania,42109,1125,1080,45,0.02040816326530612
Pennsylvania,42111,3112,3205,-93,-0.01472217824916891
Pennsylvania,42113,312,295,17,0.02800658978583196
Pennsylvania,42115,1680,1602,78,0.02376599634369287
Pennsylvania,42117,991,1264,-273,-0.12106430155210643
Pennsylvania,42119,1548,1519,29,0.009455493968046952
Pennsylvania,42121,1935,2005,-70,-0.017766497461928935
Pennsylvania,42123,1753,1582,171,0.051274362818590706
Pennsylvania,42125,15390,11013,4377,0.165776616293603
Pennsylvania,42127,1842,2010,-168,-0.04361370716510903
Pennsylvania,42129,24968,20233,4735,0.10475431959469923
Pennsylvania,42131,1123,1168,-45,-0.01964207769532955
Pennsylvania,42133,18445,17533,912,0.025348824281505363
Rhode Island,44001,3210,3507,-297,-0.04421616793211255
Rhode Island,44003,7162,10404,-3242,-0.18456108391210294
Rhode Island,44005,4433,5891,-1458,-0.14122433165439752
Rhode Island,44007,29158,35019,-5861,-0.09132555276812565
Rhode Island,44009,6136,9858,-3722,-0.23271226710016257
South Carolina,45001,1501,312,1189,0.655819084390513
South Carolina,45003,6888,2870,4018,0.4117647058823529
South Carolina,45005,1022,95,927,0.8299015219337511
South Carolina,45007,5550,2691,2859,0.346923917000364
South Carolina,45009,1715,204,1511,0.7873892652423137
South Carolina,45011,1560,209,1351,0.7637083097795364
South Carolina,45013,9945,3567,6378,0.47202486678507993
South Carolina,45015,9471,3584,5887,0.4509383378016086
South Carolina,45017,1536,241,1295,0.7287563308947664
South Carolina,45019,26535,13420,13115,0.3282442748091603
South Carolina,45021,1870,514,1356,0.5687919463087249
South Carolina,45023,1962,492,1470,0.5990220048899756
South Carolina,45025,2209,446,1763,0.664030131826742
South Carolina,45027,3564,337,3227,0.8272237887721097
South Carolina,45029,2932,583,2349,0.6682788051209104
South Carolina,45031,4988,1079,3909,0.6443052579528598
South Carolina,45033,1615,292,1323,0.6937598321971683
South Carolina,45035,6920,2876,4044,0.4128215598203348
South Carolina,45037,1474,301,1173,0.6608450704225353
South Carolina,45039,3260,440,2820,0.7621621621621621
South Carolina,45041,9411,2584,6827,0.5691538140892038
South Carolina,45043,4931,1346,3585,0.5711327067070257
South Carolina,45045,19807,10965,8842,0.28733913947744705
South Carolina,45047,3588,983,2605,0.5698971778604244
South Carolina,45049,1930,241,1689,0.7779824965453708
South Carolina,45051,11294,5449,5845,0.3491011168846682
South Carolina,45053,2194,355,1839,0.7214593958415064
South Carolina,45055,3743,1086,2657,0.5502174363222199
South Carolina,45057,3332,1213,2119,0.4662266226622662
South Carolina,45059,2952,799,2153,0.573980271927486
South Carolina,45061,2207,288,1919,0.7691382765531062
South Carolina,45063,8810,5584,3226,0.2241211615951091
South Carolina,45065,973,162,811,0.7145374449339207
South Carolina,45067,3359,552,2807,0.7177192533878803
South Carolina,45069,2132,252,1880,0.7885906040268457
South Carolina,45071,2118,469,1649,0.6374178585233862
South Carolina,45073,1960,1303,657,0.20134845234446827
South Carolina,45075,11819,1460,10359,0.7801039234882144
South Carolina,45077,2499,1988,511,0.11388455538221529
South Carolina,45079,39243,12318,26925,0.5221970093675452
South Carolina,45081,1023,192,831,0.6839506172839506
South Carolina,45083,10662,4447,6215,0.4113442319147528
South Carolina,45085,9816,1441,8375,0.743981522608155
South Carolina,45087,1690,332,1358,0.6716122650840751
South Carolina,45089,4609,557,4052,0.7843592721641502
South Carolina,45091,8895,5058,3837,0.2749946248118684
South Dakota,46003,150,132,18,0.06382978723404255
South Dakota,46005,501,373,128,0.14645308924485126
South Dakota,46007,74,95,-21,-0.1242603550295858
South Dakota,46009,225,197,28,0.06635071090047394
South Dakota,46011,955,901,54,0.029094827586206896
South Dakota,46013,1369,1138,231,0.09214200239329877
South Dakota,46015,182,219,-37,-0.09226932668329177
South Dakota,46017,110,71,39,0.2154696132596685
South Dakota,46019,167,284,-117,-0.25942350332594233
South Dakota,46021,20,26,-6,-0.13043478260869565
South Dakota,46023,293,277,16,0.028070175438596492
South Dakota,46025,112,86,26,0.13131313131313133
South Dakota,46027,623,609,14,0.011363636363636364
South Dakota,46029,828,645,183,0.12423625254582485
South Dakota,46031,115,148,-33,-0.12547528517110265
South Dakota,46033,245,276,-31,-0.05950095969289827
South Dakota,46035,542,440,102,0.10386965376782077
South Dakota,46037,343,203,140,0.2564102564102564
South Dakota,46039,162,111,51,0.18681318681318682
South Dakota,46041,181,342,-161,-0.3078393881453155
South Dakota,46043,48,37,11,0.12941176470588237
South Dakota,46045,170,155,15,0.046153846153846156
South Dakota,46047,207,304,-97,-0.1898238747553816
South Dakota,46049,86,78,8,0.04878048780487805
South Dakota,46051,528,419,109,0.11510031678986272
South Dakota,46053,179,164,15,0.043731778425655975
South Dakota,46055,23,53,-30,-0.39473684210526316
South Dakota,46057,181,125,56,0.1830065359477124
South Dakota,46059,105,98,7,0.034482758620689655
South Dakota,46061,97,83,14,0.07777777777777778
South Dakota,46063,14,40,-26,-0.48148148148148145
South Dakota,46065,528,489,39,0.038348082595870206
South Dakota,46067,151,125,26,0.09420289855072464
South Dakota,46069,40,26,14,0.21212121212121213
South Dakota,46071,59,69,-10,-0.078125
South Dakota,46073,96,65,31,0.19254658385093168
South Dakota,46075,20,31,-11,-0.21568627450980393
South Dakota,46077,201,164,37,0.10136986301369863
South Dakota,46079,484,456,28,0.029787234042553193
South Dakota,46081,705,941,-236,-0.1433778857837181
South Dakota,46083,1436,1152,284,0.10973724884080371
South Dakota,46085,115,115,0,0.0
South Dakota,46087,214,132,82,0.23699421965317918
South Dakota,46089,47,46,1,0.010752688172043012
South Dakota,46091,287,169,118,0.25877192982456143
South Dakota,46093,530,696,-166,-0.13539967373572595
South Dakota,46095,50,76,-26,-0.20634920634920634
South Dakota,46097,109,84,25,0.12953367875647667
South Dakota,46099,6018,5290,728,0.06437920056597099
South Dakota,46101,262,207,55,0.11727078891257996
South Dakota,46103,3384,3996,-612,-0.08292682926829269
South Dakota,46105,43,93,-50,-0.36764705882352944
South Dakota,46107,59,54,5,0.04424778761061947
South Dakota,46109,392,397,-5,-0.0063371356147021544
South Dakota,46111,66,45,21,0.1891891891891892
South Dakota,46113,425,574,-149,-0.14914914914914915
South Dakota,46115,283,201,82,0.16942148760330578
South Dakota,46117,95,102,-7,-0.03553299492385787
South Dakota,46119,37,51,-14,-0.1590909090909091
South Dakota,46121,408,524,-116,-0.12446351931330472
South Dakota,46123,136,147,-11,-0.038869257950530034
South Dakota,46125,232,178,54,0.13170731707317074
South Dakota,46127,380,306,74,0.10787172011661808
South Dakota,46129,121,116,5,0.02109704641350211
South Dakota,46135,706,580,126,0.09797822706065319
South Dakota,46137,92,132,-40,-0.17857142857142858
Tennessee,47001,2328,1845,483,0.11574406901509705
Tennessee,47003,1208,523,685,0.3957250144425188
Tennessee,47005,560,287,273,0.32231404958677684
Tennessee,47007,398,215,183,0.29853181076672103
Tennessee,47009,2736,2362,374,0.07336210278540604
Tennessee,47011,1644,1302,342,0.11608961303462322
Tennessee,47013,656,302,354,0.3695198329853862
Tennessee,47015,439,218,221,0.3363774733637747
Tennessee,47017,721,307,414,0.4027237354085603
Tennessee,47019,774,828,-54,-0.033707865168539325
Tennessee,47021,1065,801,264,0.1414790996784566
Tennessee,47023,342,143,199,0.41030927835051545
Tennessee,47025,544,312,232,0.27102803738317754
Tennessee,47027,270,103,167,0.4477211796246649
Tennessee,47029,463,361,102,0.12378640776699029
Tennessee,47031,1503,831,672,0.2879177377892031
Tennessee,47033,424,103,321,0.6091081593927894
Tennessee,47035,1312,888,424,0.19272727272727272
Tennessee,47037,43691,22620,21071,0.31776025093875826
Tennessee,47039,330,131,199,0.4316702819956616
Tennessee,47041,641,286,355,0.38295577130528585
Tennessee,47043,1497,696,801,0.3652530779753762
Tennessee,47045,822,304,518,0.46003552397868563
Tennessee,47047,2003,362,1641,0.6938689217758985
Tennessee,47049,352,191,161,0.2965009208103131
Tennessee,47051,1590,809,781,0.3255523134639433
Tennessee,47053,1549,427,1122,0.5678137651821862
Tennessee,47055,915,315,600,0.4878048780487805
Tennessee,47057,283,164,119,0.2662192393736018
Tennessee,47059,1079,892,187,0.09487569761542364
Tennessee,47061,445,204,241,0.3713405238828968
Tennessee,47063,951,682,269,0.16472749540722598
Tennessee,47065,15598,8411,7187,0.2993460785538756
Tennessee,47067,80,66,14,0.0958904109589041
Tennessee,47069,1721,225,1496,0.7687564234326825
Tennessee,47071,591,229,362,0.44146341463414634
Tennessee,47073,906,587,319,0.21366376423308775
Tennessee,47075,1197,143,1054,0.7865671641791044
Tennessee,47077,443,191,252,0.39747634069400634
Tennessee,47079,957,434,523,0.37598849748382457
Tennessee,47081,543,323,220,0.2540415704387991
Tennessee,47083,320,141,179,0.3882863340563991
Tennessee,47085,737,332,405,0.37885874649204865
Tennessee,47087,407,196,211,0.34991708126036486
Tennessee,47089,735,592,143,0.10776186887716654
Tennessee,47091,245,223,22,0.04700854700854701
Tennessee,47093,13137,12334,803,0.03152604923246045
Tennessee,47095,186,47,139,0.5965665236051502
Tennessee,47097,1035,194,841,0.6842961757526445
Tennessee,47099,1332,893,439,0.19730337078651686
Tennessee,47101,232,228,4,0.008695652173913044
Tennessee,47103,728,328,400,0.3787878787878788
Tennessee,47105,1026,638,388,0.23317307692307693
Tennessee,47107,1027,619,408,0.24787363304981774
Tennessee,47109,719,229,490,0.5168776371308017
Tennessee,47111,343,169,174,0.33984375
Tennessee,47113,4351,999,3352,0.6265420560747663
Tennessee,47115,1046,559,487,0.3034267912772586
Tennessee,47117,838,384,454,0.37152209492635024
Tennessee,47119,2366,1305,1061,0.2890220648324707
Tennessee,47121,354,162,192,0.37209302325581395
Tennessee,47123,1232,596,636,0.3479212253829322
Tennessee,47125,5555,2833,2722,0.3245112064854554
Tennessee,47127,209,93,116,0.3841059602649007
Tennessee,47129,356,225,131,0.22547332185886404
Tennessee,47131,760,345,415,0.3755656108597285
Tennessee,47133,885,477,408,0.29955947136563876
Tennessee,47135,215,108,107,0.33126934984520123
Tennessee,47137,214,64,150,0.539568345323741
Tennessee,47139,757,557,200,0.15220700152207
Tennessee,47141,1916,1692,224,0.06208425720620843
Tennessee,47143,503,331,172,0.20623501199040767
Tennessee,47145,1454,916,538,0.2270042194092827
Tennessee,47147,1918,827,1091,0.3974499089253188
Tennessee,47149,8243,6016,2227,0.1561820604530472
Tennessee,47151,273,180,93,0.2052980132450331
Tennessee,47153,273,206,67,0.13987473903966596
Tennessee,47155,1259,1241,18,0.0072
Tennessee,47157,66465,15985,50480,0.6122498483929655
Tennessee,47159,654,253,401,0.4421168687982359
Tennessee,47161,527,244,283,0.3670557717250324
Tennessee,47163,2653,2153,500,0.10403662089055347
Tennessee,47165,4225,2262,1963,0.3026052104208417
Tennessee,47167,1454,574,880,0.4339250493096647
Tennessee,47169,321,113,208,0.4792626728110599
Tennessee,47171,244,272,-28,-0.05426356589147287
Tennessee,47173,316,196,120,0.234375
Tennessee,47175,242,96,146,0.4319526627218935
Tennessee,47177,1318,671,647,0.32528908999497236
Tennessee,47179,2444,2833,-389,-0.07371612658707599
Tennessee,47181,208,113,95,0.29595015576323985
Tennessee,47183,860,452,408,0.31097560975609756
Tennessee,47185,688,401,287,0.263544536271809
Tennessee,47187,6055,3911,2144,0.2151314469195264
Tennessee,47189,3873,2102,1771,0.29640167364016734
Texas,48001,994,299,695,0.5375096674400619
Texas,48003,76,38,38,0.3333333333333333
Texas,48005,1950,622,1328,0.5163297045101088
Texas,48007,488,272,216,0.28421052631578947
Texas,48009,99,64,35,0.2147239263803681
Texas,48011,1,4,-3,-0.6
Texas,48013,1355,478,877,0.4784506273867976
Texas,48015,492,165,327,0.4977168949771689
Texas,48017,84,29,55,0.48672566371681414
Texas,48019,378,293,85,0.12667660208643816
Texas,48021,2894,1945,949,0.19611489977268032
Texas,48023,46,24,22,0.3142857142857143
Texas,48025,1132,320,812,0.559228650137741
Texas,48027,7416,3079,4337,0.4132444020962363
Texas,48029,76502,36720,39782,0.35136280934800657
Texas,48031,229,190,39,0.09307875894988067
Texas,48033,4,1,3,0.6
Texas,48035,353,199,154,0.27898550724637683
Texas,48037,2436,687,1749,0.5600384245917387
Texas,48039,8996,3720,5276,0.4149103491664045
Texas,48041,3559,3580,-21,-0.002941588457767194
Texas,48043,699,771,-72,-0.04897959183673469
Texas,48045,16,11,5,0.18518518518518517
Texas,48047,1603,362,1241,0.6315521628498728
Texas,48049,319,212,107,0.2015065913370998
Texas,48051,469,149,320,0.517799352750809
Texas,48053,871,576,295,0.2038700760193504
Texas,48055,1657,831,826,0.3319935691318328
Texas,48057,1024,425,599,0.41338854382332646
Texas,48059,86,104,-18,-0.09473684210526316
Texas,48061,20326,8318,12008,0.4192151934087418
Texas,48063,484,134,350,0.5663430420711975
Texas,48065,50,30,20,0.25
Texas,48067,777,264,513,0.49279538904899134
Texas,48069,127,40,87,0.5209580838323353
Texas,48071,687,293,394,0.4020408163265306
Texas,48073,989,323,666,0.5076219512195121
Texas,48075,54,34,20,0.22727272727272727
Texas,48077,120,64,56,0.30434782608695654
Texas,48079,4,3,1,0.14285714285714285
Texas,48081,25,25,0,0.0
Texas,48083,75,49,26,0.20967741935483872
Texas,48085,23591,16082,7509,0.1892723010611751
Texas,48087,36,24,12,0.2
Texas,48089,474,150,324,0.5192307692307693
Texas,48091,3109,2023,1086,0.21161340607950116
Texas,48093,217,116,101,0.3033033033033033
Texas,48095,27,11,16,0.42105263157894735
Texas,48097,449,334,115,0.14687100893997446
Texas,48099,1010,577,433,0.27284183994959044
Texas,48101,26,18,8,0.18181818181818182
Texas,48103,62,24,38,0.4418604651162791
Texas,48105,266,240,26,0.05138339920948617
Texas,48107,131,91,40,0.18018018018018017
Texas,48109,355,160,195,0.3786407766990291
Texas,48111,24,13,11,0.2972972972972973
Texas,48113,113574,44231,69343,0.43942207154399415
Texas,48115,92,34,58,0.4603174603174603
Texas,48117,200,86,114,0.3986013986013986
Texas,48119,110,51,59,0.36645962732919257
Texas,48121,16470,15750,720,0.0223463687150838
Texas,48123,293,113,180,0.4433497536945813
Texas,48125,13,11,2,0.08333333333333333
Texas,48127,1804,534,1270,0.5431993156544055
Texas,48129,33,35,-2,-0.029411764705882353
Texas,48131,2272,523,1749,0.6257602862254025
Texas,48133,171,122,49,0.16723549488054607
Texas,48135,1852,941,911,0.32617257429287505
Texas,48137,42,27,15,0.21739130434782608
Texas,48139,3719,1563,2156,0.40817872018174933
Texas,48141,36067,17176,18891,0.3548072047029657
Texas,48143,427,365,62,0.07828282828282829
Texas,48145,551,115,436,0.6546546546546547
Texas,48147,505,277,228,0.2915601023017903
Texas,48149,584,309,275,0.3079507278835386
Texas,48151,226,146,80,0.21505376344086022
Texas,48153,60,24,36,0.42857142857142855
Texas,48155,80,112,-32,-0.16666666666666666
Texas,48157,29248,9765,19483,0.4993976366852075
Texas,48159,163,73,90,0.3813559322033898
Texas,48161,380,102,278,0.5767634854771784
Texas,48163,1864,630,1234,0.49478748997594224
Texas,48165,91,59,32,0.21333333333333335
Texas,48167,9435,4233,5202,0.3805970149253731
Texas,48169,35,22,13,0.22807017543859648
Texas,48171,813,314,499,0.4427684117125111
Texas,48173,4,4,0,0.0
Texas,48175,389,151,238,0.44074074074074077
Texas,48177,368,129,239,0.48088531187122735
Texas,48179,111,86,25,0.12690355329949238
Texas,48181,1940,1687,253,0.06975461814171492
Texas,48183,3411,906,2505,0.5802640722724114
Texas,48185,583,201,382,0.4872448979591837
Texas,48187,3787,2061,1726,0.2951436388508892
Texas,48189,312,176,136,0.2786885245901639
Texas,48191,63,28,35,0.38461538461538464
Texas,48193,118,84,34,0.16831683168316833
Texas,48195,21,12,9,0.2727272727272727
Texas,48197,71,88,-17,-0.1069182389937107
Texas,48199,625,398,227,0.22189638318670576
Texas,48201,156729,63246,93483,0.4249710194340266
Texas,48203,2043,528,1515,0.5892648774795799
Texas,48205,29,19,10,0.20833333333333334
Texas,48207,159,93,66,0.2619047619047619
Texas,48209,6625,7311,-686,-0.049225028702640644
Texas,48211,15,8,7,0.30434782608695654
Texas,48213,1593,598,995,0.45413053400273845
Texas,48215,40276,15894,24382,0.4340751290724586
Texas,48217,718,297,421,0.4147783251231527
Texas,48219,183,116,67,0.22408026755852842
Texas,48221,928,527,401,0.27560137457044676
Texas,48223,628,298,330,0.3563714902807775
Texas,48225,464,101,363,0.6424778761061947
Texas,48227,350,191,159,0.29390018484288355
Texas,48229,147,97,50,0.20491803278688525
Texas,48231,1328,847,481,0.22114942528735632
Texas,48233,153,103,50,0.1953125
Texas,48235,28,14,14,0.3333333333333333
Texas,48237,87,46,41,0.3082706766917293
Texas,48239,266,94,172,0.4777777777777778
Texas,48241,932,270,662,0.5507487520798668
Texas,48243,140,132,8,0.029411764705882353
Texas,48245,16580,4440,12140,0.5775451950523312
Texas,48247,1421,356,1065,0.5993247045582443
Texas,48249,4688,1436,3252,0.5310254735467015
Texas,48251,2270,1565,705,0.18383311603650587
Texas,48253,173,94,79,0.2958801498127341
Texas,48255,719,476,243,0.20334728033472804
Texas,48257,2229,946,1283,0.40409448818897636
Texas,48259,641,491,150,0.13250883392226148
Texas,48261,63,32,31,0.3263157894736842
Texas,48263,22,28,-6,-0.12
Texas,48265,1016,707,309,0.17933836331979106
Texas,48267,29,34,-5,-0.07936507936507936
Texas,48269,2,1,1,0.3333333333333333
Texas,48271,211,107,104,0.3270440251572327
Texas,48273,1738,630,1108,0.46790540540540543
Texas,48275,68,17,51,0.6
Texas,48277,923,388,535,0.4080854309687262
Texas,48279,172,87,85,0.3281853281853282
Texas,48281,324,205,119,0.22495274102079396
Texas,48283,557,156,401,0.5624123422159888
Texas,48285,322,137,185,0.40305010893246185
Texas,48287,366,179,187,0.3431192660550459
Texas,48289,289,89,200,0.5291005291005291
Texas,48291,1041,378,663,0.46723044397463004
Texas,48293,592,144,448,0.6086956521739131
Texas,48295,22,11,11,0.3333333333333333
Texas,48297,203,72,131,0.4763636363636364
Texas,48299,512,267,245,0.31450577663671375
Texas,48301,3,5,-2,-0.25
Texas,48303,5767,4112,1655,0.1675270776394372
Texas,48305,14,10,4,0.16666666666666666
Texas,48307,93,43,50,0.36764705882352944
Texas,48309,5531,2633,2898,0.3549730524252817
Texas,48311,4,1,3,0.6
Texas,48313,227,69,158,0.5337837837837838
Texas,48315,421,123,298,0.5477941176470589
Texas,48317,36,17,19,0.3584905660377358
Texas,48319,89,50,39,0.2805755395683453
Texas,48321,1088,344,744,0.5195530726256983
Texas,48323,4342,1508,2834,0.48444444444444446
Texas,48325,1070,435,635,0.4219269102990033
Texas,48327,23,16,7,0.1794871794871795
Texas,48329,1551,852,699,0.2908863920099875
Texas,48331,577,252,325,0.39203860072376356
Texas,48333,50,41,9,0.0989010989010989
Texas,48335,109,31,78,0.5571428571428572
Texas,48337,153,122,31,0.11272727272727273
Texas,48339,7540,5040,2500,0.1987281399046105
Texas,48341,149,81,68,0.2956521739130435
Texas,48343,461,144,317,0.5239669421487604
Texas,48345,13,6,7,0.3684210526315789
Texas,48347,1597,827,770,0.31765676567656764
Texas,48349,955,333,622,0.4829192546583851
Texas,48351,605,529,76,0.06701940035273368
Texas,48353,270,122,148,0.37755102040816324
Texas,48355,15662,6172,9490,0.4346432170010076
Texas,48357,35,29,6,0.09375
Texas,48359,11,4,7,0.4666666666666667
Texas,48361,1852,816,1036,0.38830584707646176
Texas,48363,361,230,131,0.22165820642978004
Texas,48365,559,130,429,0.6226415094339622
Texas,48367,1800,1474,326,0.09957238851557727
Texas,48369,82,26,56,0.5185185185185185
Texas,48371,816,488,328,0.25153374233128833
Texas,48373,859,322,537,0.45469940728196445
Texas,48375,1490,1091,399,0.1545912437039907
Texas,48377,776,447,329,0.26901062959934585
Texas,48379,173,89,84,0.32061068702290074
Texas,48381,1586,1479,107,0.034910277324632956
Texas,48383,12,7,5,0.2631578947368421
Texas,48385,28,23,5,0.09803921568627451
Texas,48387,377,87,290,0.625
Texas,48389,1128,563,565,0.3341218214074512
Texas,48391,549,253,296,0.3690773067331671
Texas,48393,3,2,1,0.2
Texas,48395,893,289,604,0.5109983079526227
Texas,48397,1722,1038,684,0.24782608695652175
Texas,48399,80,55,25,0.18518518518518517
Texas,48401,1114,276,838,0.6028776978417266
Texas,48403,192,82,110,0.40145985401459855
Texas,48405,366,62,304,0.7102803738317757
Texas,48407,561,193,368,0.4880636604774536
Texas,48409,2633,849,1784,0.5123492245835727
Texas,48411,58,27,31,0.36470588235294116
Texas,48413,58,24,34,0.4146341463414634
Texas,48415,154,85,69,0.28870292887029286
Texas,48417,15,14,1,0.034482758620689655
Texas,48419,346,90,256,0.5871559633027523
Texas,48421,19,8,11,0.4074074074074074
Texas,48423,5752,1984,3768,0.4870734229576008
Texas,48425,66,63,3,0.023255813953488372
Texas,48427,6918,1631,5287,0.6184349046672125
Texas,48429,45,35,10,0.125
Texas,48431,5,4,1,0.1111111111111111
Texas,48433,59,36,23,0.24210526315789474
Texas,48435,27,10,17,0.4594594594594595
Texas,48437,141,78,63,0.2876712328767123
Texas,48439,67590,35507,32083,0.3111923722319757
Texas,48441,1789,1421,368,0.1146417445482866
Texas,48443,67,64,3,0.022900763358778626
Texas,48445,141,83,58,0.25892857142857145
Texas,48447,26,16,10,0.23809523809523808
Texas,48449,475,175,300,0.46153846153846156
Texas,48451,1650,1234,416,0.14424410540915394
Texas,48453,69314,73889,-4575,-0.03194765472790374
Texas,48455,333,117,216,0.48
Texas,48457,453,139,314,0.5304054054054054
Texas,48459,725,269,456,0.45875251509054327
Texas,48461,91,45,46,0.3382352941176471
Texas,48463,1740,762,978,0.3908872901678657
Texas,48465,1777,768,1009,0.39646365422396856
Texas,48467,722,377,345,0.31392174704276615
Texas,48469,2205,1118,1087,0.3271140535660548
Texas,48471,1290,788,502,0.24157844080846969
Texas,48473,1221,557,664,0.3734533183352081
Texas,48475,306,147,159,0.3509933774834437
Texas,48477,781,275,506,0.4791666666666667
Texas,48479,18559,6177,12382,0.5005659767141009
Texas,48481,960,223,737,0.6229923922231615
Texas,48483,37,23,14,0.23333333333333334
Texas,48485,1958,1544,414,0.1182181610508281
Texas,48487,136,75,61,0.2890995260663507
Texas,48489,2072,657,1415,0.5185049468669842
Texas,48491,16374,14501,1873,0.06066396761133603
Texas,48493,1280,481,799,0.45371947756956277
Texas,48495,30,11,19,0.4634146341463415
Texas,48497,750,557,193,0.1476664116296863
Texas,48499,660,284,376,0.3983050847457627
Texas,48501,9,10,-1,-0.05263157894736842
Texas,48503,198,131,67,0.20364741641337386
Texas,48505,1969,685,1284,0.48379804069329313
Texas,48507,1557,373,1184,0.6134715025906736
Utah,49001,0,0,0,0
Utah,49003,90,281,-191,-0.5148247978436657
Utah,49005,630,2906,-2276,-0.6436651583710408
Utah,49007,128,235,-107,-0.29476584022038566
Utah,49009,1,13,-12,-0.8571428571428571
Utah,49011,747,3563,-2816,-0.6533642691415313
Utah,49013,37,87,-50,-0.4032258064516129
Utah,49015,26,66,-40,-0.43478260869565216
Utah,49017,23,73,-50,-0.5208333333333334
Utah,49019,161,636,-475,-0.5959849435382685
Utah,49021,142,639,-497,-0.6363636363636364
Utah,49023,16,55,-39,-0.5492957746478874
Utah,49025,50,186,-136,-0.576271186440678
Utah,49027,9,11,-2,-0.1
Utah,49029,39,104,-65,-0.45454545454545453
Utah,49031,0,0,0,0
Utah,49033,0,0,0,0
Utah,49035,9431,35610,-26179,-0.5812259940942697
Utah,49037,44,81,-37,-0.296
Utah,49039,44,264,-220,-0.7142857142857143
Utah,49041,34,85,-51,-0.42857142857142855
Utah,49043,751,1645,-894,-0.3731218697829716
Utah,49045,240,986,-746,-0.6084828711256117
Utah,49047,39,135,-96,-0.5517241379310345
Utah,49049,1011,6071,-5060,-0.7144874329285512
Utah,49051,170,557,-387,-0.53232462173315
Utah,49053,660,1509,-849,-0.3914246196403873
Utah,49055,30,70,-40,-0.4
Utah,49057,1113,5465,-4352,-0.6615992702949225
Vermont,50001,1111,7733,-6622,-0.7487562189054726
Vermont,50003,1255,5651,-4396,-0.6365479293368086
Vermont,50005,527,4596,-4069,-0.7942611750927191
Vermont,50007,5686,32231,-26545,-0.7000817575230108
Vermont,50009,141,888,-747,-0.7259475218658892
Vermont,50011,777,6746,-5969,-0.7934334706898843
Vermont,50013,233,1529,-1296,-0.735527809307605
Vermont,50015,574,4471,-3897,-0.7724479682854312
Vermont,50017,646,5402,-4756,-0.7863756613756614
Vermont,50019,472,3539,-3067,-0.7646472201446023
Vermont,50021,1584,9350,-7766,-0.710261569416499
Vermont,50023,1719,12302,-10583,-0.7547963768632765
Vermont,50025,1416,10086,-8670,-0.7537819509650495
Vermont,50027,2194,11339,-9145,-0.6757555604817853
Virginia,51001,1789,682,1107,0.4479967624443545
Virginia,51003,8284,6838,1446,0.09562227218621876
Virginia,51005,433,246,187,0.27540500736377027
Virginia,51007,671,179,492,0.5788235294117647
Virginia,51009,1044,546,498,0.3132075471698113
Virginia,51011,448,215,233,0.3514328808446455
Virginia,51013,25561,12541,13020,0.3417143457036376
Virginia,51015,1639,1754,-115,-0.03389330975537872
Virginia,51017,148,86,62,0.26495726495726496
Virginia,51019,1876,1424,452,0.13696969696969696
Virginia,51021,125,114,11,0.04602510460251046
Virginia,51023,888,695,193,0.12192040429564119
Virginia,51025,1354,152,1202,0.798140770252324
Virginia,51027,523,210,313,0.42701227830832195
Virginia,51029,806,264,542,0.5065420560747663
Virginia,51031,1296,667,629,0.32042791645440655
Virginia,51033,1902,641,1261,0.49587101848210774
Virginia,51035,600,445,155,0.14832535885167464
Virginia,51036,863,141,722,0.7191235059760956
Virginia,51037,635,162,473,0.5934755332496863
Virginia,51041,22674,11510,11164,0.326585537093377
Virginia,51043,625,581,44,0.03648424543946932
Virginia,51045,113,106,7,0.0319634703196347
Virginia,51047,1421,1154,267,0.10368932038834952
Virginia,51049,639,158,481,0.6035131744040151
Virginia,51051,346,223,123,0.21616871704745166
Virginia,51053,1935,375,1560,0.6753246753246753
Virginia,51057,642,133,509,0.6567741935483871
Virginia,51059,86898,50217,36681,0.26751996499288916
Virginia,51061,2860,2345,515,0.0989433237271854
Virginia,51063,396,935,-539,-0.4049586776859504
Virginia,51065,1355,983,372,0.15911035072711718
Virginia,51067,1674,980,694,0.2614920874152223
Virginia,51069,2136,2064,72,0.017142857142857144
Virginia,51071,405,316,89,0.12343966712898752
Virginia,51073,1448,993,455,0.18639901679639492
Virginia,51075,1572,618,954,0.43561643835616437
Virginia,51077,265,269,-4,-0.00749063670411985
Virginia,51079,579,603,-24,-0.02030456852791878
Virginia,51081,832,113,719,0.7608465608465609
Virginia,51083,1754,403,1351,0.626332869726472
Virginia,51085,4915,3253,1662,0.2034769833496572
Virginia,51087,28121,11954,16167,0.40341859014348097
Virginia,51089,1809,664,1145,0.4630004043671654
Virginia,51091,86,88,-2,-0.011494252873563218
Virginia,51093,2446,853,1593,0.48287359806001817
Virginia,51095,5210,2750,2460,0.30904522613065327
Virginia,51097,477,126,351,0.582089552238806
Virginia,51099,916,612,304,0.19895287958115182
Virginia,51101,841,315,526,0.45501730103806226
Virginia,51103,823,275,548,0.4990892531876138
Virginia,51105,299,161,138,0.3
Virginia,51107,21171,14719,6452,0.179771524101421
Virginia,51109,1630,849,781,0.3150463896732553
Virginia,51111,738,141,597,0.6791808873720137
Virginia,51113,538,370,168,0.18502202643171806
Virginia,51115,435,246,189,0.2775330396475771
Virginia,51117,1588,378,1210,0.6154628687690743
Virginia,51119,559,295,264,0.3091334894613583
Virginia,51121,3506,5090,-1584,-0.1842717543043276
Virginia,51125,991,760,231,0.13192461450599657
Virginia,51127,951,440,511,0.36736161035226456
Virginia,51131,868,324,544,0.4563758389261745
Virginia,51133,818,265,553,0.5106186518928901
Virginia,51135,829,224,605,0.5745489078822412
Virginia,51137,1322,870,452,0.2062043795620438
Virginia,51139,411,353,58,0.07591623036649214
Virginia,51141,361,372,-11,-0.015006821282401092
Virginia,51143,2369,766,1603,0.511323763955343
Virginia,51145,1079,592,487,0.291442250149611
Virginia,51147,1366,420,946,0.5296752519596865
Virginia,51149,1992,566,1426,0.5574667709147771
Virginia,51153,26439,14696,11743,0.28547465661845145
Virginia,51155,837,588,249,0.17473684210526316
Virginia,51157,416,411,5,0.006045949214026602
Virginia,51159,333,80,253,0.612590799031477
Virginia,51161,3323,2760,563,0.09255301660364952
Virginia,51163,902,676,226,0.1432192648922687
Virginia,51165,1734,1941,-207,-0.0563265306122449
Virginia,51167,556,360,196,0.21397379912663755
Virginia,51169,305,233,72,0.13382899628252787
Virginia,51171,958,928,30,0.015906680805938492
Virginia,51173,526,361,165,0.18602029312288612
Virginia,51175,1199,216,983,0.6946996466431096
Virginia,51177,5399,3480,1919,0.21612794233584864
Virginia,51179,6437,4140,2297,0.21716932967760236
Virginia,51181,812,174,638,0.6470588235294118
Virginia,51183,958,98,860,0.8143939393939394
Virginia,51185,683,476,207,0.17860224331320104
Virginia,51187,941,1007,-66,-0.033880903490759756
Virginia,51191,1181,984,197,0.09099307159353348
Virginia,51193,879,295,584,0.49744463373083475
Virginia,51195,519,553,-34,-0.03171641791044776
Virginia,51197,528,423,105,0.11041009463722397
Virginia,51199,3292,2040,1252,0.2348087021755439
Virginia,51510,16281,7008,9273,0.3981708102537679
Virginia,51520,428,324,104,0.13829787234042554
Virginia,51530,143,100,43,0.17695473251028807
Virginia,51540,3888,4474,-586,-0.07007892848600814
Virginia,51550,16126,5551,10575,0.4878442588919131
Virginia,51570,407,316,91,0.12586445366528354
Virginia,51580,244,85,159,0.48328267477203646
Virginia,51590,2676,655,2021,0.6067247072951065
Virginia,51595,404,52,352,0.7719298245614035
Virginia,51600,1840,1243,597,0.1936425559519948
Virginia,51610,1587,1000,587,0.22690374951681486
Virginia,51620,831,104,727,0.7775401069518717
Virginia,51630,1396,1238,158,0.05998481397114654
Virginia,51640,129,92,37,0.167420814479638
Virginia,51650,13529,3764,9765,0.5646793500260221
Virginia,51660,1481,2911,-1430,-0.325591985428051
Virginia,51670,1177,337,840,0.5548216644649934
Virginia,51678,402,250,152,0.2331288343558282
Virginia,51680,3104,1920,1184,0.2356687898089172
Virginia,51683,1812,1280,532,0.17205692108667528
Virginia,51685,581,427,154,0.1527777777777778
Virginia,51690,834,264,570,0.5191256830601093
Virginia,51700,12495,4556,7939,0.46560319042871384
Virginia,51710,15747,6925,8822,0.38911432604093155
Virginia,51720,86,72,14,0.08860759493670886
Virginia,51730,4099,687,3412,0.712912661930631
Virginia,51735,295,335,-40,-0.06349206349206349
Virginia,51740,9464,2540,6924,0.5768077307564146
Virginia,51750,472,655,-183,-0.16237799467613132
Virginia,51760,21822,14085,7737,0.21547330604060488
Virginia,51770,4783,3299,1484,0.1836179163573373
Virginia,51775,824,774,50,0.03128911138923655
Virginia,51790,1114,1364,-250,-0.10088781275221953
Virginia,51800,7533,1893,5640,0.5983450031826862
Virginia,51810,22352,12969,9383,0.26564933042665834
Virginia,51820,788,769,19,0.012202954399486191
Virginia,51830,1159,1197,-38,-0.016129032258064516
Virginia,51840,949,900,49,0.02650081124932396
Washington,53001,6,17,-11,-0.4782608695652174
Washington,53003,21,43,-22,-0.34375
Washington,53005,107,385,-278,-0.5650406504065041
Washington,53007,63,160,-97,-0.4349775784753363
Washington,53009,85,188,-103,-0.3772893772893773
Washington,53011,297,1080,-783,-0.5686274509803921
Washington,53013,3,10,-7,-0.5384615384615384
Washington,53015,76,255,-179,-0.540785498489426
Washington,53017,23,63,-40,-0.46511627906976744
Washington,53019,5,18,-13,-0.5652173913043478
Washington,53021,29,115,-86,-0.5972222222222222
Washington,53023,2,3,-1,-0.2
Washington,53025,29,112,-83,-0.5886524822695035
Washington,53027,65,176,-111,-0.4605809128630705
Washington,53029,97,219,-122,-0.3860759493670886
Washington,53031,56,135,-79,-0.41361256544502617
Washington,53033,3246,6704,-3458,-0.34753768844221106
Washington,53035,238,631,-393,-0.4522439585730725
Washington,53037,31,106,-75,-0.5474452554744526
Washington,53039,11,55,-44,-0.6666666666666666
Washington,53041,36,166,-130,-0.6435643564356436
Washington,53043,8,22,-14,-0.4666666666666667
Washington,53045,55,159,-104,-0.48598130841121495
Washington,53047,23,154,-131,-0.7401129943502824
Washington,53049,18,77,-59,-0.6210526315789474
Washington,53051,10,35,-25,-0.5555555555555556
Washington,53053,712,1968,-1256,-0.46865671641791046
Washington,53055,25,79,-54,-0.5192307692307693
Washington,53057,116,322,-206,-0.4703196347031963
Washington,53059,5,46,-41,-0.803921568627451
Washington,53061,677,2165,-1488,-0.5235749472202674
Washington,53063,333,1199,-866,-0.5652741514360313
Washington,53065,23,101,-78,-0.6290322580645161
Washington,53067,245,868,-623,-0.559748427672956
Washington,53069,2,17,-15,-0.7894736842105263
Washington,53071,45,109,-64,-0.4155844155844156
Washington,53073,166,695,-529,-0.6144018583042973
Washington,53075,28,109,-81,-0.5912408759124088
Washington,53077,123,393,-270,-0.5232558139534884
West Virginia,54001,686,994,-308,-0.18333333333333332
West Virginia,54003,3591,4020,-429,-0.0563657863618447
West Virginia,54005,1244,2410,-1166,-0.3191023535851122
West Virginia,54007,899,1321,-422,-0.1900900900900901
West Virginia,54009,1489,1966,-477,-0.13806078147612155
West Virginia,54011,4407,5361,-954,-0.09766584766584767
West Virginia,54013,312,803,-491,-0.44035874439461886
West Virginia,54015,434,754,-320,-0.26936026936026936
West Virginia,54017,115,235,-120,-0.34285714285714286
West Virginia,54019,2317,3585,-1268,-0.21484242629617079
West Virginia,54021,343,643,-300,-0.30425963488843816
West Virginia,54023,168,185,-17,-0.04815864022662889
West Virginia,54025,1894,2864,-970,-0.20386717108028585
West Virginia,54027,719,1101,-382,-0.2098901098901099
West Virginia,54029,1547,2275,-728,-0.19047619047619047
West Virginia,54031,655,883,-228,-0.1482444733420026
West Virginia,54033,4184,5370,-1186,-0.12413648733514758
West Virginia,54035,1443,1799,-356,-0.10980876002467613
West Virginia,54037,2910,3241,-331,-0.05381238822955617
West Virginia,54039,12628,13480,-852,-0.03263367550176191
West Virginia,54041,712,1229,-517,-0.2663575476558475
West Virginia,54043,1015,1510,-495,-0.19603960396039605
West Virginia,54045,1491,3201,-1710,-0.36445012787723785
West Virginia,54047,781,1453,-672,-0.3008057296329454
West Virginia,54049,3556,5324,-1768,-0.1990990990990991
West Virginia,54051,1449,2599,-1150,-0.2840909090909091
West Virginia,54053,1221,1769,-548,-0.18327759197324414
West Virginia,54055,2167,3233,-1066,-0.19740740740740742
West Virginia,54057,854,1110,-256,-0.13034623217922606
West Virginia,54059,1074,2425,-1351,-0.38611031723349526
West Virginia,54061,4963,8096,-3133,-0.23991117237154452
West Virginia,54063,604,817,-213,-0.1498944405348346
West Virginia,54065,486,682,-196,-0.1678082191780822
West Virginia,54067,1086,1944,-858,-0.28316831683168314
West Virginia,54069,2468,3363,-895,-0.15348996741553764
West Virginia,54071,384,484,-100,-0.1152073732718894
West Virginia,54073,329,545,-216,-0.2471395881006865
West Virginia,54075,524,826,-302,-0.2237037037037037
West Virginia,54077,957,1719,-762,-0.28475336322869954
West Virginia,54079,2543,3251,-708,-0.12219537452537108
West Virginia,54081,3225,4888,-1663,-0.20497966227043019
West Virginia,54083,1515,2492,-977,-0.24382330920888445
West Virginia,54085,199,351,-152,-0.27636363636363637
West Virginia,54087,741,1002,-261,-0.14974182444061962
West Virginia,54089,779,1060,-281,-0.1528004350190321
West Virginia,54091,764,1106,-342,-0.18288770053475936
West Virginia,54093,330,770,-440,-0.4
West Virginia,54095,202,428,-226,-0.35873015873015873
West Virginia,54097,738,1071,-333,-0.18407960199004975
West Virginia,54099,1934,2898,-964,-0.19950331125827814
West Virginia,54101,384,837,-453,-0.371007371007371
West Virginia,54103,845,1744,-899,-0.3472383159521051
West Virginia,54105,170,326,-156,-0.31451612903225806
West Virginia,54107,3169,4519,-1350,-0.1755983350676379
West Virginia,54109,710,1498,-788,-0.35688405797101447
Wisconsin,55001,1373,1501,-128,-0.04453723034098817
Wisconsin,55003,1346,2304,-958,-0.26246575342465756
Wisconsin,55005,2570,2960,-390,-0.0705244122965642
Wisconsin,55007,1484,2604,-1120,-0.273972602739726
Wisconsin,55009,16626,22471,-5845,-0.14949996163388496
Wisconsin,55011,825,1148,-323,-0.16371008616320323
Wisconsin,55013,917,933,-16,-0.008648648648648649
Wisconsin,55015,3031,4010,-979,-0.13904274960943047
Wisconsin,55017,4021,5114,-1093,-0.1196496989600438
Wisconsin,55019,1475,1942,-467,-0.1366695932104185
Wisconsin,55021,4183,6455,-2272,-0.213573980071442
Wisconsin,55023,1132,1582,-450,-0.1658069270449521
Wisconsin,55025,61072,102585,-41513,-0.25365856639190504
Wisconsin,55027,4501,6243,-1742,-0.16213700670141473
Wisconsin,55029,2935,3417,-482,-0.0758816120906801
Wisconsin,55031,3574,4510,-936,-0.11578426521523998
Wisconsin,55033,2421,4272,-1851,-0.2765575974899148
Wisconsin,55035,7323,13058,-5735,-0.2813895294637162
Wisconsin,55037,175,293,-118,-0.25213675213675213
Wisconsin,55039,5514,7375,-1861,-0.14438668632166965
Wisconsin,55041,609,647,-38,-0.030254777070063694
Wisconsin,55043,3036,4484,-1448,-0.1925531914893617
Wisconsin,55045,2766,4359,-1593,-0.22357894736842104
Wisconsin,55047,869,1148,-279,-0.1383242439266237
Wisconsin,55049,2161,3198,-1037,-0.19350625116626236
Wisconsin,55051,437,543,-106,-0.10816326530612246
Wisconsin,55053,1294,1845,-551,-0.1755336094297547
Wisconsin,55055,4771,7537,-2766,-0.22473188170295744
Wisconsin,55057,1357,1843,-486,-0.151875
Wisconsin,55059,10871,14612,-3741,-0.14680375152062158
Wisconsin,55061,1495,1662,-167,-0.05289832119100412
Wisconsin,55063,8901,15139,-6238,-0.25948419301164727
Wisconsin,55065,1167,1330,-163,-0.06527833400080096
Wisconsin,55067,1192,1436,-244,-0.0928462709284627
Wisconsin,55069,1732,2439,-707,-0.16950371613521936
Wisconsin,55071,4983,6447,-1464,-0.12808398950131233
Wisconsin,55073,8047,11655,-3608,-0.18312861638412345
Wisconsin,55075,2577,2692,-115,-0.021825773391535394
Wisconsin,55077,994,1320,-326,-0.14088159031979255
Wisconsin,55078,204,355,-151,-0.2701252236135957
Wisconsin,55079,100932,93714,7218,0.03708270398569711
Wisconsin,55081,2270,3533,-1263,-0.21764604514906083
Wisconsin,55083,2418,2577,-159,-0.03183183183183183
Wisconsin,55085,2493,3809,-1316,-0.20882259600126943
Wisconsin,55087,11202,16985,-5783,-0.2051655018270834
Wisconsin,55089,6572,6871,-299,-0.02224205906419698
Wisconsin,55091,435,560,-125,-0.12562814070351758
Wisconsin,55093,2340,3199,-859,-0.1550821447914786
Wisconsin,55095,2174,2473,-299,-0.06434258661502044
Wisconsin,55097,5036,9348,-4312,-0.29977753058954393
Wisconsin,55099,854,1393,-539,-0.2398753894080997
Wisconsin,55101,14086,14651,-565,-0.019661064133347252
Wisconsin,55103,1276,1784,-508,-0.16601307189542483
Wisconsin,55105,11248,17337,-6089,-0.21301381843624279
Wisconsin,55107,817,1093,-276,-0.14450261780104712
Wisconsin,55109,4891,5671,-780,-0.07384964968755918
Wisconsin,55111,4526,7195,-2669,-0.22771094616500298
Wisconsin,55113,975,1652,-677,-0.2577084126379901
Wisconsin,55115,2124,2976,-852,-0.16705882352941176
Wisconsin,55117,7175,8537,-1362,-0.08668533604887983
Wisconsin,55119,850,1278,-428,-0.20112781954887218
Wisconsin,55121,1988,2429,-441,-0.09984152139461172
Wisconsin,55123,1934,3476,-1542,-0.2850277264325323
Wisconsin,55125,1412,2140,-728,-0.20495495495495494
Wisconsin,55127,5174,8405,-3231,-0.23794093821341777
Wisconsin,55129,1059,1417,-358,-0.14458804523424879
Wisconsin,55131,6381,7676,-1295,-0.09212491996869887
Wisconsin,55133,24784,26339,-1555,-0.030416837822506503
Wisconsin,55135,2582,3883,-1301,-0.20123743232791957
Wisconsin,55137,1181,1502,-321,-0.11964219157659337
Wisconsin,55139,11193,17818,-6625,-0.22836165592361518
Wisconsin,55141,4424,6747,-2323,-0.20794915405961867
Wyoming,56001,8,25,-17,-0.5151515151515151
Wyoming,56003,2,2,0,0.0
Wyoming,56005,6,12,-6,-0.3333333333333333
Wyoming,56007,4,3,1,0.14285714285714285
Wyoming,56009,2,3,-1,-0.2
Wyoming,56011,1,1,0,0.0
Wyoming,56013,10,10,0,0.0
Wyoming,56015,3,2,1,0.2
Wyoming,56017,1,1,0,0.0
Wyoming,56019,1,1,0,0.0
Wyoming,56021,26,25,1,0.0196078431372549
Wyoming,56023,3,3,0,0.0
Wyoming,56025,20,18,2,0.05263157894736842
Wyoming,56027,0,2,-2,-1.0
Wyoming,56029,5,8,-3,-0.23076923076923078
Wyoming,56031,1,2,-1,-0.3333333333333333
Wyoming,56033,7,7,0,0.0
Wyoming,56035,1,3,-2,-0.5
Wyoming,56037,10,12,-2,-0.09090909090909091
Wyoming,56039,6,9,-3,-0.2
Wyoming,56041,4,5,-1,-0.1111111111111111
Wyoming,56043,2,1,1,0.3333333333333333
Wyoming,56045,1,1,0,0.0
